date,product_id,city,quantity_sold,opening_stock,closing_stock
2024-01-01,PROD001,Jilin,6,648,642
2024-01-02,PROD010,Shenzhen,1,1121,1120
2024-01-03,PROD007,Shanghai,7,739,732
2024-01-04,PROD002,Shanghai,2,691,689
2024-01-05,PROD010,Guangzhou,2,1495,1493
2024-01-06,PROD009,Beijing,7,757,750
2024-01-07,PROD015,Beijing,7,1115,1108
2024-01-08,PROD001,Shenzhen,8,858,850
2024-01-09,PROD004,Shanghai,4,1405,1401
2024-01-10,PROD002,Shenzhen,10,1384,1374
2024-01-11,PROD014,Beijing,2,671,669
2024-01-12,PROD019,Shenzhen,5,950,945
2024-01-13,PROD010,Jilin,5,676,671
2024-01-14,PROD005,Beijing,9,899,890
2024-01-15,PROD001,Shanghai,8,1230,1222
2024-01-16,PROD011,Jilin,6,723,717
2024-01-17,PROD003,Guangzhou,2,1257,1255
2024-01-18,PROD016,Shanghai,7,1400,1393
2024-01-19,PROD007,Jilin,4,607,603
2024-01-20,PROD012,Shanghai,6,963,957
2024-01-21,PROD012,Shanghai,9,957,948
2024-01-22,PROD009,Beijing,10,750,740
2024-01-23,PROD012,Shanghai,1,948,947
2024-01-24,PROD009,Guangzhou,6,1377,1371
2024-01-25,PROD003,Shanghai,1,1252,1251
2024-01-26,PROD020,Shanghai,5,664,659
2024-01-27,PROD005,Shenzhen,9,881,872
2024-01-28,PROD011,Beijing,8,1489,1481
2024-01-29,PROD003,Shenzhen,10,1187,1177
2024-01-30,PROD009,Guangzhou,5,1371,1366
2024-01-31,PROD010,Beijing,6,1450,1444
2024-02-01,PROD003,Shenzhen,6,1177,1171
2024-02-02,PROD014,Beijing,3,669,666
2024-02-03,PROD017,Shanghai,9,967,958
2024-02-04,PROD010,Shenzhen,4,1120,1116
2024-02-05,PROD019,Shanghai,9,1273,1264
2024-02-06,PROD015,Shanghai,2,598,596
2024-02-07,PROD018,Shanghai,9,1138,1129
2024-02-08,PROD007,Guangzhou,5,1129,1124
2024-02-09,PROD015,Shanghai,10,596,586
2024-02-10,PROD016,Guangzhou,1,541,540
2024-02-11,PROD005,Beijing,3,890,887
2024-02-12,PROD012,Guangzhou,2,626,624
2024-02-13,PROD001,Shenzhen,6,850,844
2024-02-14,PROD002,Guangzhou,5,1224,1219
2024-02-15,PROD013,Jilin,4,1021,1017
2024-02-16,PROD014,Shanghai,10,880,870
2024-02-17,PROD014,Guangzhou,5,575,570
2024-02-18,PROD004,Beijing,5,920,915
2024-02-19,PROD010,Shanghai,3,868,865
2024-02-20,PROD004,Shenzhen,8,584,576
2024-02-21,PROD005,Shanghai,10,995,985
2024-02-22,PROD018,Beijing,7,1133,1126
2024-02-23,PROD019,Beijing,6,823,817
2024-02-24,PROD016,Shanghai,10,1393,1383
2024-02-25,PROD013,Beijing,5,1250,1245
2024-02-26,PROD001,Shenzhen,4,844,840
2024-02-27,PROD007,Jilin,9,603,594
2024-02-28,PROD005,Shenzhen,2,872,870
2024-02-29,PROD018,Shenzhen,10,1241,1231
2024-03-01,PROD016,Shenzhen,1,595,594
2024-03-02,PROD001,Shenzhen,7,840,833
2024-03-03,PROD010,Guangzhou,3,1493,1490
2024-03-04,PROD008,Beijing,2,678,676
2024-03-05,PROD013,Shenzhen,10,1374,1364
2024-03-06,PROD014,Shenzhen,8,861,853
2024-03-07,PROD009,Shanghai,6,741,735
2024-03-08,PROD013,Jilin,1,1017,1016
2024-03-09,PROD008,Beijing,4,676,672
2024-03-10,PROD016,Guangzhou,7,540,533
2024-03-11,PROD006,Shanghai,8,623,615
2024-03-12,PROD011,Guangzhou,9,989,980
2024-03-13,PROD001,Shenzhen,5,833,828
2024-03-14,PROD010,Shenzhen,10,1116,1106
2024-03-15,PROD008,Shanghai,8,652,644
2024-03-16,PROD012,Shenzhen,3,506,503
2024-03-17,PROD016,Shenzhen,1,594,593
2024-03-18,PROD013,Shanghai,4,1184,1180
2024-03-19,PROD013,Shanghai,9,1180,1171
2024-03-20,PROD016,Jilin,8,845,837
2024-03-21,PROD005,Shanghai,9,985,976
2024-03-22,PROD018,Jilin,2,1493,1491
2024-03-23,PROD004,Shanghai,8,1401,1393
2024-03-24,PROD019,Jilin,3,1052,1049
2024-03-25,PROD010,Jilin,2,671,669
2024-03-26,PROD011,Jilin,8,717,709
2024-03-27,PROD001,Jilin,4,642,638
2024-03-28,PROD017,Shanghai,7,958,951
2024-03-29,PROD018,Shanghai,8,1129,1121
2024-03-30,PROD005,Beijing,9,887,878
2024-03-31,PROD017,Shenzhen,9,1026,1017
2024-04-01,PROD010,Shanghai,3,865,862
2024-04-02,PROD003,Shanghai,10,1251,1241
2024-04-03,PROD013,Shanghai,8,1171,1163
2024-04-04,PROD001,Shanghai,7,1222,1215
2024-04-05,PROD002,Beijing,4,1095,1091
2024-04-06,PROD015,Beijing,10,1108,1098
2024-04-07,PROD016,Beijing,6,1320,1314
2024-04-08,PROD011,Guangzhou,7,980,973
2024-04-09,PROD007,Jilin,7,594,587
2024-04-10,PROD013,Guangzhou,3,915,912
2024-04-11,PROD006,Jilin,8,1028,1020
2024-04-12,PROD006,Shenzhen,1,619,618
2024-04-13,PROD007,Beijing,4,509,505
2024-04-14,PROD001,Beijing,4,571,567
2024-04-15,PROD016,Shanghai,2,1383,1381
2024-04-16,PROD005,Shenzhen,10,870,860
2024-04-17,PROD019,Beijing,10,817,807
2024-04-18,PROD002,Guangzhou,6,1219,1213
2024-04-19,PROD010,Beijing,6,1444,1438
2024-04-20,PROD006,Guangzhou,5,1401,1396
2024-04-21,PROD020,Beijing,9,1264,1255
2024-04-22,PROD005,Beijing,4,878,874
2024-04-23,PROD014,Guangzhou,5,570,565
2024-04-24,PROD014,Jilin,5,942,937
2024-04-25,PROD007,Shenzhen,4,794,790
2024-04-26,PROD008,Guangzhou,10,1474,1464
2024-04-27,PROD008,Guangzhou,2,1464,1462
2024-04-28,PROD010,Beijing,3,1438,1435
2024-04-29,PROD012,Beijing,7,1323,1316
2024-04-30,PROD005,Guangzhou,7,655,648
2024-05-01,PROD019,Jilin,4,1049,1045
2024-05-02,PROD010,Shenzhen,7,1106,1099
2024-05-03,PROD019,Guangzhou,1,1356,1355
2024-05-04,PROD007,Guangzhou,7,1124,1117
2024-05-05,PROD007,Guangzhou,6,1117,1111
2024-05-06,PROD004,Guangzhou,9,1440,1431
2024-05-07,PROD009,Shenzhen,2,762,760
2024-05-08,PROD007,Jilin,8,587,579
2024-05-09,PROD005,Beijing,6,874,868
2024-05-10,PROD017,Jilin,2,1351,1349
2024-05-11,PROD018,Shanghai,5,1121,1116
2024-05-12,PROD003,Guangzhou,1,1255,1254
2024-05-13,PROD020,Beijing,7,1255,1248
2024-05-14,PROD018,Shanghai,7,1116,1109
2024-05-15,PROD006,Guangzhou,5,1396,1391
2024-05-16,PROD020,Shanghai,3,659,656
2024-05-17,PROD018,Beijing,8,1126,1118
2024-05-18,PROD007,Shanghai,2,732,730
2024-05-19,PROD010,Beijing,7,1435,1428
2024-05-20,PROD014,Beijing,4,666,662
2024-05-21,PROD008,Beijing,2,672,670
2024-05-22,PROD001,Shenzhen,6,828,822
2024-05-23,PROD008,Beijing,2,670,668
2024-05-24,PROD006,Shanghai,10,615,605
2024-05-25,PROD001,Guangzhou,3,1272,1269
2024-05-26,PROD019,Beijing,7,807,800
2024-05-27,PROD018,Guangzhou,7,1223,1216
2024-05-28,PROD012,Guangzhou,8,624,616
2024-05-29,PROD008,Guangzhou,5,1462,1457
2024-05-30,PROD008,Beijing,4,668,664
2024-05-31,PROD001,Shenzhen,7,822,815
2024-06-01,PROD018,Guangzhou,4,1216,1212
2024-06-02,PROD001,Shanghai,4,1215,1211
2024-06-03,PROD010,Beijing,2,1428,1426
2024-06-04,PROD015,Jilin,8,1192,1184
2024-06-05,PROD002,Jilin,1,1105,1104
2024-06-06,PROD017,Jilin,6,1349,1343
2024-06-07,PROD015,Jilin,6,1184,1178
2024-06-08,PROD016,Shanghai,10,1381,1371
2024-06-09,PROD012,Shenzhen,9,503,494
2024-06-10,PROD020,Shanghai,5,656,651
2024-06-11,PROD019,Guangzhou,3,1355,1352
2024-06-12,PROD007,Jilin,4,579,575
2024-06-13,PROD019,Guangzhou,7,1352,1345
2024-06-14,PROD001,Jilin,4,638,634
2024-06-15,PROD005,Shanghai,2,976,974
2024-06-16,PROD001,Jilin,5,634,629
2024-06-17,PROD006,Guangzhou,6,1391,1385
2024-06-18,PROD002,Jilin,3,1104,1101
2024-06-19,PROD011,Shanghai,1,777,776
2024-06-20,PROD006,Shenzhen,9,618,609
2024-06-21,PROD006,Guangzhou,3,1385,1382
2024-06-22,PROD008,Shenzhen,9,948,939
2024-06-23,PROD005,Jilin,2,986,984
2024-06-24,PROD018,Jilin,3,1491,1488
2024-06-25,PROD015,Shenzhen,4,981,977
2024-06-26,PROD014,Jilin,8,937,929
2024-06-27,PROD014,Beijing,2,662,660
2024-06-28,PROD006,Shanghai,2,605,603
2024-06-29,PROD006,Shenzhen,5,609,604
2024-06-30,PROD019,Guangzhou,3,1345,1342
2024-07-01,PROD015,Jilin,8,1178,1170
2024-07-02,PROD015,Beijing,5,1098,1093
2024-07-03,PROD002,Jilin,6,1101,1095
2024-07-04,PROD001,Shanghai,9,1211,1202
2024-07-05,PROD017,Jilin,10,1343,1333
2024-07-06,PROD012,Guangzhou,7,616,609
2024-07-07,PROD019,Shanghai,1,1264,1263
2024-07-08,PROD015,Guangzhou,5,954,949
2024-07-09,PROD007,Shanghai,9,730,721
2024-07-10,PROD010,Jilin,6,669,663
2024-07-11,PROD002,Guangzhou,8,1213,1205
2024-07-12,PROD012,Jilin,3,1065,1062
2024-07-13,PROD012,Jilin,4,1062,1058
2024-07-14,PROD006,Shenzhen,8,604,596
2024-07-15,PROD004,Shenzhen,3,576,573
2024-07-16,PROD015,Guangzhou,9,949,940
2024-07-17,PROD017,Shanghai,1,951,950
2024-07-18,PROD012,Guangzhou,3,609,606
2024-07-19,PROD005,Guangzhou,4,648,644
2024-07-20,PROD001,Beijing,3,567,564
2024-07-21,PROD001,Jilin,6,629,623
2024-07-22,PROD005,Beijing,6,868,862
2024-07-23,PROD003,Shenzhen,1,1171,1170
2024-07-24,PROD011,Jilin,5,709,704
2024-07-25,PROD020,Shanghai,6,651,645
2024-07-26,PROD006,Guangzhou,9,1382,1373
2024-07-27,PROD012,Jilin,4,1058,1054
2024-07-28,PROD017,Jilin,9,1333,1324
2024-07-29,PROD010,Shenzhen,7,1099,1092
2024-07-30,PROD008,Guangzhou,4,1457,1453
2024-07-31,PROD005,Jilin,8,984,976
2024-08-01,PROD014,Shanghai,6,870,864
2024-08-02,PROD020,Jilin,3,1372,1369
2024-08-03,PROD005,Jilin,1,976,975
2024-08-04,PROD013,Beijing,4,1245,1241
2024-08-05,PROD019,Shanghai,8,1263,1255
2024-08-06,PROD009,Shanghai,7,735,728
2024-08-07,PROD014,Jilin,7,929,922
2024-08-08,PROD013,Shanghai,8,1163,1155
2024-08-09,PROD020,Beijing,7,1248,1241
2024-08-10,PROD016,Shanghai,6,1371,1365
2024-08-11,PROD014,Shanghai,10,864,854
2024-08-12,PROD012,Shanghai,7,947,940
2024-08-13,PROD009,Shanghai,5,728,723
2024-08-14,PROD018,Shanghai,8,1109,1101
2024-08-15,PROD002,Jilin,2,1095,1093
2024-08-16,PROD011,Guangzhou,3,973,970
2024-08-17,PROD012,Shenzhen,4,494,490
2024-08-18,PROD016,Shenzhen,10,593,583
2024-08-19,PROD017,Guangzhou,6,602,596
2024-08-20,PROD004,Beijing,5,915,910
2024-08-21,PROD019,Jilin,6,1045,1039
2024-08-22,PROD003,Jilin,10,1372,1362
2024-08-23,PROD015,Guangzhou,3,940,937
2024-08-24,PROD018,Jilin,2,1488,1486
2024-08-25,PROD011,Beijing,2,1481,1479
2024-08-26,PROD017,Shenzhen,5,1017,1012
2024-08-27,PROD001,Beijing,1,564,563
2024-08-28,PROD006,Beijing,2,1065,1063
2024-08-29,PROD004,Beijing,1,910,909
2024-08-30,PROD004,Beijing,2,909,907
2024-08-31,PROD013,Guangzhou,4,912,908
2024-09-01,PROD006,Beijing,3,1063,1060
2024-09-02,PROD009,Guangzhou,2,1366,1364
2024-09-03,PROD004,Shenzhen,4,573,569
2024-09-04,PROD019,Shanghai,10,1255,1245
2024-09-05,PROD014,Shanghai,5,854,849
2024-09-06,PROD006,Jilin,2,1020,1018
2024-09-07,PROD009,Jilin,9,637,628
2024-09-08,PROD012,Shenzhen,3,490,487
2024-09-09,PROD018,Jilin,3,1486,1483
2024-09-10,PROD014,Shenzhen,2,853,851
2024-09-11,PROD020,Shenzhen,10,1275,1265
2024-09-12,PROD008,Jilin,9,815,806
2024-09-13,PROD012,Guangzhou,4,606,602
2024-09-14,PROD020,Shanghai,4,645,641
2024-09-15,PROD010,Guangzhou,6,1490,1484
2024-09-16,PROD005,Guangzhou,5,644,639
2024-09-17,PROD014,Jilin,10,922,912
2024-09-18,PROD017,Beijing,7,1354,1347
2024-09-19,PROD001,Guangzhou,2,1269,1267
2024-09-20,PROD001,Jilin,9,623,614
2024-09-21,PROD008,Shanghai,10,644,634
2024-09-22,PROD011,Guangzhou,2,970,968
2024-09-23,PROD015,Shenzhen,1,977,976
2024-09-24,PROD011,Shenzhen,1,1087,1086
2024-09-25,PROD016,Shenzhen,10,583,573
2024-09-26,PROD012,Shenzhen,5,487,482
2024-09-27,PROD018,Beijing,6,1118,1112
2024-09-28,PROD011,Jilin,2,704,702
2024-09-29,PROD002,Guangzhou,10,1205,1195
2024-09-30,PROD001,Shanghai,2,1202,1200
2024-10-01,PROD016,Guangzhou,2,533,531
2024-10-02,PROD005,Shanghai,2,974,972
2024-10-03,PROD017,Guangzhou,3,596,593
2024-10-04,PROD009,Shenzhen,5,760,755
2024-10-05,PROD016,Shenzhen,3,573,570
2024-10-06,PROD002,Jilin,8,1093,1085
2024-10-07,PROD016,Shenzhen,3,570,567
2024-10-08,PROD015,Guangzhou,7,937,930
2024-10-09,PROD017,Beijing,5,1347,1342
2024-10-10,PROD019,Jilin,1,1039,1038
2024-10-11,PROD010,Shenzhen,3,1092,1089
2024-10-12,PROD012,Guangzhou,5,602,597
2024-10-13,PROD015,Beijing,8,1093,1085
2024-10-14,PROD018,Jilin,10,1483,1473
2024-10-15,PROD019,Shenzhen,2,945,943
2024-10-16,PROD007,Jilin,8,575,567
2024-10-17,PROD013,Guangzhou,8,908,900
2024-10-18,PROD013,Shenzhen,4,1364,1360
2024-10-19,PROD004,Shanghai,4,1393,1389
2024-10-20,PROD019,Shanghai,2,1245,1243
2024-10-21,PROD015,Shenzhen,5,976,971
2024-10-22,PROD015,Beijing,3,1085,1082
2024-10-23,PROD009,Guangzhou,5,1364,1359
2024-10-24,PROD009,Guangzhou,7,1359,1352
2024-10-25,PROD002,Jilin,8,1085,1077
2024-10-26,PROD003,Guangzhou,1,1254,1253
2024-10-27,PROD016,Guangzhou,2,531,529
2024-10-28,PROD015,Beijing,2,1082,1080
2024-10-29,PROD020,Guangzhou,9,716,707
2024-10-30,PROD007,Jilin,3,567,564
2024-10-31,PROD017,Guangzhou,10,593,583
2024-11-01,PROD005,Jilin,3,975,972
2024-11-02,PROD017,Jilin,8,1324,1316
2024-11-03,PROD008,Jilin,6,806,800
2024-11-04,PROD011,Shanghai,7,776,769
2024-11-05,PROD008,Shenzhen,10,939,929
2024-11-06,PROD014,Shenzhen,4,851,847
2024-11-07,PROD007,Jilin,3,564,561
2024-11-08,PROD008,Shenzhen,5,929,924
2024-11-09,PROD004,Guangzhou,9,1431,1422
2024-11-10,PROD020,Jilin,3,1369,1366
2024-11-11,PROD017,Shanghai,7,950,943
2024-11-12,PROD007,Shenzhen,7,790,783
2024-11-13,PROD015,Jilin,8,1170,1162
2024-11-14,PROD009,Jilin,7,628,621
2024-11-15,PROD010,Jilin,10,663,653
2024-11-16,PROD017,Jilin,5,1316,1311
2024-11-17,PROD002,Jilin,9,1077,1068
2024-11-18,PROD017,Shenzhen,5,1012,1007
2024-11-19,PROD013,Guangzhou,8,900,892
2024-11-20,PROD017,Shanghai,9,943,934
2024-11-21,PROD010,Shenzhen,2,1089,1087
2024-11-22,PROD007,Jilin,8,561,553
2024-11-23,PROD005,Beijing,8,862,854
2024-11-24,PROD005,Shenzhen,4,860,856
2024-11-25,PROD009,Shanghai,5,723,718
2024-11-26,PROD016,Shanghai,8,1365,1357
2024-11-27,PROD013,Guangzhou,2,892,890
2024-11-28,PROD006,Shanghai,6,603,597
2024-11-29,PROD015,Shenzhen,6,971,965
2024-11-30,PROD008,Shanghai,10,634,624
2024-12-01,PROD018,Shanghai,2,1101,1099
2024-12-02,PROD018,Guangzhou,2,1212,1210
2024-12-03,PROD010,Guangzhou,4,1484,1480
2024-12-04,PROD015,Guangzhou,10,930,920
2024-12-05,PROD003,Guangzhou,3,1253,1250
2024-12-06,PROD019,Jilin,1,1038,1037
2024-12-07,PROD002,Beijing,6,1091,1085
2024-12-08,PROD007,Shanghai,10,721,711
2024-12-09,PROD001,Shenzhen,4,815,811
2024-12-10,PROD018,Beijing,2,1112,1110
2024-12-11,PROD020,Shenzhen,4,1265,1261
2024-12-12,PROD003,Jilin,4,1362,1358
2024-12-13,PROD018,Shanghai,8,1099,1091
2024-12-14,PROD005,Shenzhen,5,856,851
2024-12-15,PROD008,Shenzhen,2,924,922
2024-12-16,PROD014,Shanghai,6,849,843
2024-12-17,PROD008,Beijing,8,664,656
2024-12-18,PROD020,Shanghai,10,641,631
2024-12-19,PROD008,Shanghai,2,624,622
2024-12-20,PROD017,Jilin,7,1311,1304
2024-12-21,PROD014,Shenzhen,4,847,843
2024-12-22,PROD010,Beijing,2,1426,1424
2024-12-23,PROD009,Shanghai,7,718,711
2024-12-24,PROD020,Shanghai,1,631,630
2024-12-25,PROD015,Shanghai,4,586,582
2024-12-26,PROD016,Beijing,10,1314,1304
2024-12-27,PROD016,Shenzhen,2,567,565
2024-12-28,PROD020,Beijing,8,1241,1233
2024-12-29,PROD008,Beijing,2,656,654
2024-12-30,PROD018,Shenzhen,4,1231,1227
2024-01-01,PROD003,Shenzhen,1,1170,1169
2024-01-02,PROD016,Shenzhen,7,565,558
2024-01-03,PROD017,Beijing,9,1342,1333
2024-01-04,PROD020,Shenzhen,2,1261,1259
2024-01-05,PROD018,Guangzhou,2,1210,1208
2024-01-06,PROD002,Shenzhen,7,1374,1367
2024-01-07,PROD017,Jilin,7,1304,1297
2024-01-08,PROD019,Shenzhen,2,943,941
2024-01-09,PROD002,Jilin,5,1068,1063
2024-01-10,PROD019,Guangzhou,4,1342,1338
2024-01-11,PROD002,Shenzhen,3,1367,1364
2024-01-12,PROD011,Beijing,3,1479,1476
2024-01-13,PROD020,Beijing,6,1233,1227
2024-01-14,PROD004,Shanghai,8,1389,1381
2024-01-15,PROD010,Guangzhou,2,1480,1478
2024-01-16,PROD002,Shanghai,4,689,685
2024-01-17,PROD017,Beijing,10,1333,1323
2024-01-18,PROD015,Shanghai,9,582,573
2024-01-19,PROD007,Shenzhen,6,783,777
2024-01-20,PROD017,Shenzhen,4,1007,1003
2024-01-21,PROD005,Shanghai,9,972,963
2024-01-22,PROD019,Guangzhou,6,1338,1332
2024-01-23,PROD014,Shanghai,9,843,834
2024-01-24,PROD010,Shenzhen,9,1087,1078
2024-01-25,PROD004,Shanghai,3,1381,1378
2024-01-26,PROD016,Beijing,9,1304,1295
2024-01-27,PROD019,Guangzhou,10,1332,1322
2024-01-28,PROD006,Shanghai,10,597,587
2024-01-29,PROD007,Shenzhen,6,777,771
2024-01-30,PROD009,Beijing,3,740,737
2024-01-31,PROD012,Jilin,9,1054,1045
2024-02-01,PROD006,Jilin,1,1018,1017
2024-02-02,PROD013,Shanghai,4,1155,1151
2024-02-03,PROD005,Beijing,3,854,851
2024-02-04,PROD009,Jilin,3,621,618
2024-02-05,PROD020,Shanghai,2,630,628
2024-02-06,PROD013,Jilin,8,1016,1008
2024-02-07,PROD009,Beijing,4,737,733
2024-02-08,PROD015,Guangzhou,8,920,912
2024-02-09,PROD013,Shenzhen,4,1360,1356
2024-02-10,PROD008,Guangzhou,4,1453,1449
2024-02-11,PROD010,Shenzhen,9,1078,1069
2024-02-12,PROD016,Shenzhen,9,558,549
2024-02-13,PROD019,Shanghai,1,1243,1242
2024-02-14,PROD015,Jilin,3,1162,1159
2024-02-15,PROD007,Jilin,4,553,549
2024-02-16,PROD020,Beijing,8,1227,1219
2024-02-17,PROD020,Guangzhou,10,707,697
2024-02-18,PROD010,Shanghai,9,862,853
2024-02-19,PROD014,Jilin,8,912,904
2024-02-20,PROD002,Guangzhou,9,1195,1186
2024-02-21,PROD001,Beijing,1,563,562
2024-02-22,PROD002,Guangzhou,6,1186,1180
2024-02-23,PROD015,Shanghai,4,573,569
2024-02-24,PROD001,Shanghai,4,1200,1196
2024-02-25,PROD001,Guangzhou,10,1267,1257
2024-02-26,PROD016,Shenzhen,6,549,543
2024-02-27,PROD005,Shanghai,3,963,960
2024-02-28,PROD012,Beijing,3,1316,1313
2024-02-29,PROD004,Shenzhen,5,569,564
2024-03-01,PROD017,Beijing,7,1323,1316
2024-03-02,PROD018,Guangzhou,1,1208,1207
2024-03-03,PROD011,Beijing,3,1476,1473
2024-03-04,PROD013,Guangzhou,8,890,882
2024-03-05,PROD013,Guangzhou,8,882,874
2024-03-06,PROD006,Jilin,7,1017,1010
2024-03-07,PROD002,Guangzhou,2,1180,1178
2024-03-08,PROD004,Guangzhou,3,1422,1419
2024-03-09,PROD017,Jilin,3,1297,1294
2024-03-10,PROD010,Shanghai,10,853,843
2024-03-11,PROD008,Jilin,10,800,790
2024-03-12,PROD001,Beijing,4,562,558
2024-03-13,PROD014,Jilin,2,904,902
2024-03-14,PROD015,Shanghai,2,569,567
2024-03-15,PROD018,Guangzhou,10,1207,1197
2024-03-16,PROD009,Guangzhou,8,1352,1344
2024-03-17,PROD014,Shenzhen,3,843,840
2024-03-18,PROD013,Shenzhen,7,1356,1349
2024-03-19,PROD013,Jilin,2,1008,1006
2024-03-20,PROD015,Jilin,8,1159,1151
2024-03-21,PROD017,Jilin,6,1294,1288
2024-03-22,PROD017,Shanghai,1,934,933
2024-03-23,PROD005,Jilin,8,972,964
2024-03-24,PROD007,Beijing,9,505,496
2024-03-25,PROD010,Shenzhen,5,1069,1064
2024-03-26,PROD004,Guangzhou,4,1419,1415
2024-03-27,PROD016,Shenzhen,10,543,533
2024-03-28,PROD020,Shenzhen,5,1259,1254
2024-03-29,PROD006,Beijing,8,1060,1052
2024-03-30,PROD019,Shenzhen,2,941,939
2024-03-31,PROD019,Shanghai,5,1242,1237
2024-04-01,PROD019,Guangzhou,7,1322,1315
2024-04-02,PROD011,Guangzhou,5,968,963
2024-04-03,PROD005,Jilin,1,964,963
2024-04-04,PROD004,Guangzhou,3,1415,1412
2024-04-05,PROD014,Jilin,7,902,895
2024-04-06,PROD015,Jilin,3,1151,1148
2024-04-07,PROD019,Jilin,1,1037,1036
2024-04-08,PROD005,Guangzhou,4,639,635
2024-04-09,PROD010,Guangzhou,2,1478,1476
2024-04-10,PROD008,Jilin,9,790,781
2024-04-11,PROD013,Guangzhou,3,874,871
2024-04-12,PROD019,Beijing,7,800,793
2024-04-13,PROD003,Jilin,5,1358,1353
2024-04-14,PROD014,Jilin,7,895,888
2024-04-15,PROD004,Guangzhou,10,1412,1402
2024-04-16,PROD006,Shenzhen,10,596,586
2024-04-17,PROD001,Shanghai,4,1196,1192
2024-04-18,PROD010,Shenzhen,4,1064,1060
2024-04-19,PROD014,Shenzhen,7,840,833
2024-04-20,PROD001,Jilin,4,614,610
2024-04-21,PROD006,Guangzhou,4,1373,1369
2024-04-22,PROD006,Guangzhou,9,1369,1360
2024-04-23,PROD010,Guangzhou,10,1476,1466
2024-04-24,PROD015,Guangzhou,3,912,909
2024-04-25,PROD009,Shanghai,10,711,701
2024-04-26,PROD014,Shenzhen,7,833,826
2024-04-27,PROD012,Guangzhou,9,597,588
2024-04-28,PROD005,Beijing,5,851,846
2024-04-29,PROD005,Beijing,8,846,838
2024-04-30,PROD004,Beijing,1,907,906
2024-05-01,PROD011,Beijing,7,1473,1466
2024-05-02,PROD009,Beijing,2,733,731
2024-05-03,PROD015,Guangzhou,7,909,902
2024-05-04,PROD013,Shenzhen,1,1349,1348
2024-05-05,PROD012,Shenzhen,2,482,480
2024-05-06,PROD016,Jilin,9,837,828
2024-05-07,PROD017,Shanghai,8,933,925
2024-05-08,PROD001,Shenzhen,3,811,808
2024-05-09,PROD010,Shenzhen,1,1060,1059
2024-05-10,PROD002,Shanghai,4,685,681
2024-05-11,PROD008,Shenzhen,8,922,914
2024-05-12,PROD009,Jilin,5,618,613
2024-05-13,PROD003,Guangzhou,2,1250,1248
2024-05-14,PROD001,Shenzhen,3,808,805
2024-05-15,PROD008,Shanghai,9,622,613
2024-05-16,PROD013,Guangzhou,7,871,864
2024-05-17,PROD007,Jilin,5,549,544
2024-05-18,PROD014,Guangzhou,10,565,555
2024-05-19,PROD014,Shenzhen,2,826,824
2024-05-20,PROD013,Jilin,3,1006,1003
2024-05-21,PROD009,Shenzhen,3,755,752
2024-05-22,PROD004,Shanghai,3,1378,1375
2024-05-23,PROD012,Beijing,10,1313,1303
2024-05-24,PROD012,Jilin,10,1045,1035
2024-05-25,PROD003,Shanghai,9,1241,1232
2024-05-26,PROD005,Shenzhen,10,851,841
2024-05-27,PROD012,Beijing,10,1303,1293
2024-05-28,PROD013,Shenzhen,1,1348,1347
2024-05-29,PROD007,Shanghai,6,711,705
2024-05-30,PROD002,Guangzhou,10,1178,1168
2024-05-31,PROD013,Beijing,1,1241,1240
2024-06-01,PROD012,Beijing,7,1293,1286
2024-06-02,PROD011,Guangzhou,9,963,954
2024-06-03,PROD009,Jilin,9,613,604
2024-06-04,PROD013,Shanghai,8,1151,1143
2024-06-05,PROD006,Shenzhen,7,586,579
2024-06-06,PROD017,Jilin,7,1288,1281
2024-06-07,PROD006,Shanghai,2,587,585
2024-06-08,PROD010,Guangzhou,9,1466,1457
2024-06-09,PROD017,Jilin,8,1281,1273
2024-06-10,PROD017,Beijing,10,1316,1306
2024-06-11,PROD015,Shanghai,7,567,560
2024-06-12,PROD015,Shanghai,3,560,557
2024-06-13,PROD009,Shenzhen,6,752,746
2024-06-14,PROD015,Jilin,4,1148,1144
2024-06-15,PROD002,Jilin,2,1063,1061
2024-06-16,PROD008,Beijing,6,654,648
2024-06-17,PROD009,Jilin,2,604,602
2024-06-18,PROD018,Shenzhen,10,1227,1217
2024-06-19,PROD020,Jilin,6,1366,1360
2024-06-20,PROD001,Guangzhou,7,1257,1250
2024-06-21,PROD008,Jilin,9,781,772
2024-06-22,PROD004,Shenzhen,7,564,557
2024-06-23,PROD008,Shanghai,10,613,603
2024-06-24,PROD004,Jilin,3,584,581
2024-06-25,PROD018,Jilin,6,1473,1467
2024-06-26,PROD019,Jilin,2,1036,1034
2024-06-27,PROD007,Guangzhou,1,1111,1110
2024-06-28,PROD015,Jilin,9,1144,1135
2024-06-29,PROD020,Jilin,6,1360,1354
2024-06-30,PROD003,Jilin,5,1353,1348
2024-07-01,PROD012,Jilin,6,1035,1029
2024-07-02,PROD004,Beijing,5,906,901
2024-07-03,PROD005,Jilin,1,963,962
2024-07-04,PROD004,Beijing,5,901,896
2024-07-05,PROD009,Beijing,9,731,722
2024-07-06,PROD017,Beijing,7,1306,1299
2024-07-07,PROD009,Shenzhen,8,746,738
2024-07-08,PROD010,Beijing,5,1424,1419
2024-07-09,PROD002,Guangzhou,8,1168,1160
2024-07-10,PROD004,Guangzhou,1,1402,1401
2024-07-11,PROD003,Guangzhou,9,1248,1239
2024-07-12,PROD019,Shanghai,6,1237,1231
2024-07-13,PROD016,Guangzhou,7,529,522
2024-07-14,PROD005,Shanghai,4,960,956
2024-07-15,PROD010,Jilin,4,653,649
2024-07-16,PROD020,Shanghai,10,628,618
2024-07-17,PROD010,Beijing,8,1419,1411
2024-07-18,PROD018,Shenzhen,3,1217,1214
2024-07-19,PROD018,Guangzhou,5,1197,1192
2024-07-20,PROD008,Jilin,2,772,770
2024-07-21,PROD020,Shanghai,4,618,614
2024-07-22,PROD002,Guangzhou,10,1160,1150
2024-07-23,PROD003,Guangzhou,9,1239,1230
2024-07-24,PROD017,Shenzhen,3,1003,1000
2024-07-25,PROD020,Jilin,2,1354,1352
2024-07-26,PROD001,Guangzhou,2,1250,1248
2024-07-27,PROD020,Guangzhou,5,697,692
2024-07-28,PROD018,Shanghai,3,1091,1088
2024-07-29,PROD017,Beijing,10,1299,1289
2024-07-30,PROD013,Shenzhen,7,1347,1340
2024-07-31,PROD005,Jilin,10,962,952
2024-08-01,PROD012,Beijing,6,1286,1280
2024-08-02,PROD018,Shenzhen,9,1214,1205
2024-08-03,PROD009,Beijing,4,722,718
2024-08-04,PROD001,Shanghai,10,1192,1182
2024-08-05,PROD018,Guangzhou,6,1192,1186
2024-08-06,PROD001,Beijing,5,558,553
2024-08-07,PROD010,Shenzhen,6,1059,1053
2024-08-08,PROD011,Jilin,10,702,692
2024-08-09,PROD001,Shenzhen,5,805,800
2024-08-10,PROD014,Shanghai,6,834,828
2024-08-11,PROD016,Shanghai,7,1357,1350
2024-08-12,PROD009,Shanghai,9,701,692
2024-08-13,PROD005,Shanghai,1,956,955
2024-08-14,PROD011,Shenzhen,5,1086,1081
2024-08-15,PROD020,Guangzhou,8,692,684
2024-08-16,PROD008,Shenzhen,5,914,909
2024-08-17,PROD003,Guangzhou,3,1230,1227
2024-08-18,PROD015,Shenzhen,4,965,961
2024-08-19,PROD014,Guangzhou,1,555,554
2024-08-20,PROD009,Beijing,5,718,713
2024-08-21,PROD018,Beijing,8,1110,1102
2024-08-22,PROD017,Beijing,8,1289,1281
2024-08-23,PROD016,Shanghai,1,1350,1349
2024-08-24,PROD019,Beijing,4,793,789
2024-08-25,PROD013,Jilin,9,1003,994
2024-08-26,PROD001,Shenzhen,2,800,798
2024-08-27,PROD017,Shanghai,2,925,923
2024-08-28,PROD004,Jilin,9,581,572
2024-08-29,PROD017,Jilin,7,1273,1266
2024-08-30,PROD006,Shanghai,1,585,584
2024-08-31,PROD002,Beijing,1,1085,1084
2024-09-01,PROD015,Shanghai,3,557,554
2024-09-02,PROD003,Guangzhou,3,1227,1224
2024-09-03,PROD015,Beijing,3,1080,1077
2024-09-04,PROD015,Shenzhen,10,961,951
2024-09-05,PROD015,Shanghai,2,554,552
2024-09-06,PROD017,Shanghai,10,923,913
2024-09-07,PROD017,Jilin,10,1266,1256
2024-09-08,PROD005,Shenzhen,5,841,836
2024-09-09,PROD015,Shanghai,6,552,546
2024-09-10,PROD007,Shanghai,5,705,700
2024-09-11,PROD013,Shanghai,4,1143,1139
2024-09-12,PROD007,Beijing,4,496,492
2024-09-13,PROD010,Shanghai,2,843,841
2024-09-14,PROD009,Shenzhen,4,738,734
2024-09-15,PROD016,Shenzhen,4,533,529
2024-09-16,PROD015,Guangzhou,3,902,899
2024-09-17,PROD018,Shanghai,5,1088,1083
2024-09-18,PROD003,Shanghai,2,1232,1230
2024-09-19,PROD004,Jilin,4,572,568
2024-09-20,PROD011,Jilin,10,692,682
2024-09-21,PROD013,Jilin,5,994,989
2024-09-22,PROD007,Shenzhen,3,771,768
2024-09-23,PROD003,Jilin,7,1348,1341
2024-09-24,PROD015,Beijing,1,1077,1076
2024-09-25,PROD004,Guangzhou,8,1401,1393
2024-09-26,PROD009,Guangzhou,8,1344,1336
2024-09-27,PROD012,Jilin,3,1029,1026
2024-09-28,PROD002,Shanghai,4,681,677
2024-09-29,PROD002,Jilin,2,1061,1059
2024-09-30,PROD005,Guangzhou,9,635,626
2024-10-01,PROD012,Beijing,10,1280,1270
2024-10-02,PROD009,Shanghai,3,692,689
2024-10-03,PROD009,Beijing,9,713,704
2024-10-04,PROD002,Guangzhou,2,1150,1148
2024-10-05,PROD005,Shenzhen,1,836,835
2024-10-06,PROD004,Jilin,2,568,566
2024-10-07,PROD018,Shanghai,7,1083,1076
2024-10-08,PROD018,Beijing,9,1102,1093
2024-10-09,PROD012,Jilin,9,1026,1017
2024-10-10,PROD020,Guangzhou,3,684,681
2024-10-11,PROD013,Jilin,3,989,986
2024-10-12,PROD001,Beijing,4,553,549
2024-10-13,PROD012,Guangzhou,5,588,583
2024-10-14,PROD013,Jilin,9,986,977
2024-10-15,PROD016,Shanghai,10,1349,1339
2024-10-16,PROD005,Shenzhen,1,835,834
2024-10-17,PROD011,Jilin,4,682,678
2024-10-18,PROD003,Guangzhou,5,1224,1219
2024-10-19,PROD006,Beijing,6,1052,1046
2024-10-20,PROD020,Guangzhou,1,681,680
2024-10-21,PROD016,Shanghai,7,1339,1332
2024-10-22,PROD014,Guangzhou,5,554,549
2024-10-23,PROD001,Guangzhou,2,1248,1246
2024-10-24,PROD006,Shanghai,8,584,576
2024-10-25,PROD001,Beijing,3,549,546
2024-10-26,PROD003,Jilin,2,1341,1339
2024-10-27,PROD005,Beijing,8,838,830
2024-10-28,PROD019,Shenzhen,2,939,937
2024-10-29,PROD010,Shanghai,7,841,834
2024-10-30,PROD006,Beijing,4,1046,1042
2024-10-31,PROD013,Beijing,5,1240,1235
2024-11-01,PROD011,Guangzhou,3,954,951
2024-11-02,PROD017,Beijing,3,1281,1278
2024-11-03,PROD004,Beijing,7,896,889
2024-11-04,PROD020,Shanghai,5,614,609
2024-11-05,PROD018,Beijing,2,1093,1091
2024-11-06,PROD012,Guangzhou,6,583,577
2024-11-07,PROD005,Shenzhen,7,834,827
2024-11-08,PROD013,Guangzhou,6,864,858
2024-11-09,PROD011,Shanghai,6,769,763
2024-11-10,PROD013,Beijing,7,1235,1228
2024-11-11,PROD001,Shenzhen,4,798,794
2024-11-12,PROD004,Guangzhou,1,1393,1392
2024-11-13,PROD010,Beijing,10,1411,1401
2024-11-14,PROD005,Guangzhou,7,626,619
2024-11-15,PROD001,Beijing,9,546,537
2024-11-16,PROD001,Beijing,1,537,536
2024-11-17,PROD015,Beijing,6,1076,1070
2024-11-18,PROD003,Shenzhen,1,1169,1168
2024-11-19,PROD012,Beijing,4,1270,1266
2024-11-20,PROD014,Jilin,2,888,886
2024-11-21,PROD019,Shanghai,7,1231,1224
2024-11-22,PROD008,Shanghai,8,603,595
2024-11-23,PROD016,Guangzhou,7,522,515
2024-11-24,PROD009,Jilin,4,602,598
2024-11-25,PROD020,Beijing,8,1219,1211
2024-11-26,PROD016,Beijing,1,1295,1294
2024-11-27,PROD002,Beijing,2,1084,1082
2024-11-28,PROD001,Jilin,10,610,600
2024-11-29,PROD009,Guangzhou,2,1336,1334
2024-11-30,PROD010,Shenzhen,3,1053,1050
2024-12-01,PROD020,Guangzhou,4,680,676
2024-12-02,PROD008,Jilin,1,770,769
2024-12-03,PROD012,Beijing,3,1266,1263
2024-12-04,PROD001,Shanghai,6,1182,1176
2024-12-05,PROD020,Jilin,7,1352,1345
2024-12-06,PROD013,Guangzhou,6,858,852
2024-12-07,PROD011,Shenzhen,3,1081,1078
2024-12-08,PROD001,Shanghai,3,1176,1173
2024-12-09,PROD004,Jilin,2,566,564
2024-12-10,PROD014,Beijing,5,660,655
2024-12-11,PROD013,Shanghai,3,1139,1136
2024-12-12,PROD003,Guangzhou,10,1219,1209
2024-12-13,PROD019,Shanghai,1,1224,1223
2024-12-14,PROD017,Shanghai,5,913,908
2024-12-15,PROD013,Shanghai,1,1136,1135
2024-12-16,PROD002,Beijing,6,1082,1076
2024-12-17,PROD011,Shenzhen,5,1078,1073
2024-12-18,PROD004,Shanghai,7,1375,1368
2024-12-19,PROD020,Shanghai,6,609,603
2024-12-20,PROD005,Guangzhou,3,619,616
2024-12-21,PROD002,Beijing,6,1076,1070
2024-12-22,PROD011,Shenzhen,1,1073,1072
2024-12-23,PROD012,Beijing,2,1263,1261
2024-12-24,PROD009,Guangzhou,2,1334,1332
2024-12-25,PROD013,Jilin,3,977,974
2024-12-26,PROD001,Shanghai,5,1173,1168
2024-12-27,PROD011,Jilin,5,678,673
2024-12-28,PROD002,Jilin,6,1059,1053
2024-12-29,PROD001,Shanghai,3,1168,1165
2024-12-30,PROD003,Guangzhou,5,1209,1204
2024-01-01,PROD019,Guangzhou,4,1315,1311
2024-01-02,PROD014,Shanghai,10,828,818
2024-01-03,PROD004,Shanghai,1,1368,1367
2024-01-04,PROD017,Shenzhen,10,1000,990
2024-01-05,PROD020,Shenzhen,10,1254,1244
2024-01-06,PROD015,Shanghai,8,546,538
2024-01-07,PROD017,Jilin,4,1256,1252
2024-01-08,PROD015,Guangzhou,3,899,896
2024-01-09,PROD019,Shenzhen,10,937,927
2024-01-10,PROD008,Guangzhou,9,1449,1440
2024-01-11,PROD008,Jilin,1,769,768
2024-01-12,PROD013,Shanghai,4,1135,1131
2024-01-13,PROD006,Shanghai,5,576,571
2024-01-14,PROD010,Jilin,8,649,641
2024-01-15,PROD002,Shenzhen,9,1364,1355
2024-01-16,PROD007,Jilin,1,544,543
2024-01-17,PROD007,Jilin,4,543,539
2024-01-18,PROD009,Shenzhen,3,734,731
2024-01-19,PROD008,Guangzhou,3,1440,1437
2024-01-20,PROD008,Shenzhen,10,909,899
2024-01-21,PROD015,Guangzhou,8,896,888
2024-01-22,PROD011,Guangzhou,6,951,945
2024-01-23,PROD008,Shanghai,7,595,588
2024-01-24,PROD003,Jilin,6,1339,1333
2024-01-25,PROD004,Guangzhou,1,1392,1391
2024-01-26,PROD007,Shanghai,7,700,693
2024-01-27,PROD015,Beijing,9,1070,1061
2024-01-28,PROD003,Beijing,5,1428,1423
2024-01-29,PROD005,Jilin,3,952,949
2024-01-30,PROD009,Shenzhen,7,731,724
2024-01-31,PROD002,Shenzhen,1,1355,1354
2024-02-01,PROD001,Guangzhou,9,1246,1237
2024-02-02,PROD020,Beijing,5,1211,1206
2024-02-03,PROD012,Jilin,9,1017,1008
2024-02-04,PROD003,Shenzhen,6,1168,1162
2024-02-05,PROD010,Shanghai,3,834,831
2024-02-06,PROD004,Shenzhen,7,557,550
2024-02-07,PROD005,Shenzhen,7,827,820
2024-02-08,PROD008,Shenzhen,10,899,889
2024-02-09,PROD001,Shanghai,1,1165,1164
2024-02-10,PROD011,Guangzhou,4,945,941
2024-02-11,PROD013,Beijing,9,1228,1219
2024-02-12,PROD008,Shanghai,8,588,580
2024-02-13,PROD014,Shenzhen,3,824,821
2024-02-14,PROD008,Jilin,10,768,758
2024-02-15,PROD016,Shanghai,10,1332,1322
2024-02-16,PROD013,Shanghai,8,1131,1123
2024-02-17,PROD009,Beijing,10,704,694
2024-02-18,PROD013,Beijing,7,1219,1212
2024-02-19,PROD017,Guangzhou,1,583,582
2024-02-20,PROD001,Shenzhen,6,794,788
2024-02-21,PROD002,Guangzhou,4,1148,1144
2024-02-22,PROD007,Beijing,10,492,482
2024-02-23,PROD001,Shanghai,3,1164,1161
2024-02-24,PROD018,Guangzhou,4,1186,1182
2024-02-25,PROD005,Shenzhen,7,820,813
2024-02-26,PROD018,Guangzhou,7,1182,1175
2024-02-27,PROD018,Jilin,2,1467,1465
2024-02-28,PROD016,Beijing,7,1294,1287
2024-02-29,PROD020,Shanghai,1,603,602
2024-03-01,PROD010,Shanghai,7,831,824
2024-03-02,PROD003,Guangzhou,6,1204,1198
2024-03-03,PROD016,Jilin,8,828,820
2024-03-04,PROD013,Shenzhen,8,1340,1332
2024-03-05,PROD008,Jilin,8,758,750
2024-03-06,PROD015,Beijing,2,1061,1059
2024-03-07,PROD009,Shenzhen,8,724,716
2024-03-08,PROD006,Shanghai,5,571,566
2024-03-09,PROD018,Shenzhen,10,1205,1195
2024-03-10,PROD011,Shanghai,10,763,753
2024-03-11,PROD001,Shenzhen,3,788,785
2024-03-12,PROD010,Shanghai,4,824,820
2024-03-13,PROD005,Jilin,9,949,940
2024-03-14,PROD020,Jilin,4,1345,1341
2024-03-15,PROD006,Shanghai,2,566,564
2024-03-16,PROD017,Shanghai,9,908,899
2024-03-17,PROD002,Shenzhen,10,1354,1344
2024-03-18,PROD011,Guangzhou,6,941,935
2024-03-19,PROD004,Shanghai,3,1367,1364
2024-03-20,PROD004,Shanghai,2,1364,1362
2024-03-21,PROD004,Jilin,9,564,555
2024-03-22,PROD014,Jilin,8,886,878
2024-03-23,PROD020,Shanghai,2,602,600
2024-03-24,PROD001,Jilin,6,600,594
2024-03-25,PROD017,Beijing,1,1278,1277
2024-03-26,PROD008,Guangzhou,2,1437,1435
2024-03-27,PROD012,Shenzhen,8,480,472
2024-03-28,PROD009,Jilin,6,598,592
2024-03-29,PROD007,Beijing,7,482,475
2024-03-30,PROD001,Shenzhen,3,785,782
2024-03-31,PROD004,Shanghai,7,1362,1355
2024-04-01,PROD008,Shanghai,8,580,572
2024-04-02,PROD003,Jilin,7,1333,1326
2024-04-03,PROD015,Shanghai,5,538,533
2024-04-04,PROD017,Shanghai,3,899,896
2024-04-05,PROD006,Beijing,7,1042,1035
2024-04-06,PROD018,Jilin,2,1465,1463
2024-04-07,PROD020,Jilin,3,1341,1338
2024-04-08,PROD016,Jilin,1,820,819
2024-04-09,PROD018,Shanghai,9,1076,1067
2024-04-10,PROD012,Shenzhen,8,472,464
2024-04-11,PROD017,Beijing,4,1277,1273
2024-04-12,PROD004,Jilin,9,555,546
2024-04-13,PROD015,Shenzhen,1,951,950
2024-04-14,PROD007,Beijing,7,475,468
2024-04-15,PROD008,Guangzhou,1,1435,1434
2024-04-16,PROD012,Shenzhen,3,464,461
2024-04-17,PROD003,Jilin,9,1326,1317
2024-04-18,PROD012,Beijing,7,1261,1254
2024-04-19,PROD009,Shenzhen,7,716,709
2024-04-20,PROD008,Jilin,4,750,746
2024-04-21,PROD014,Shenzhen,6,821,815
2024-04-22,PROD018,Shanghai,5,1067,1062
2024-04-23,PROD015,Beijing,1,1059,1058
2024-04-24,PROD001,Shenzhen,10,782,772
2024-04-25,PROD014,Jilin,9,878,869
2024-04-26,PROD017,Guangzhou,7,582,575
2024-04-27,PROD013,Shenzhen,1,1332,1331
2024-04-28,PROD014,Shenzhen,6,815,809
2024-04-29,PROD007,Shenzhen,10,768,758
2024-04-30,PROD018,Shanghai,3,1062,1059
2024-05-01,PROD003,Guangzhou,10,1198,1188
2024-05-02,PROD013,Shenzhen,8,1331,1323
2024-05-03,PROD008,Guangzhou,10,1434,1424
2024-05-04,PROD010,Shanghai,7,820,813
2024-05-05,PROD017,Guangzhou,7,575,568
2024-05-06,PROD003,Guangzhou,1,1188,1187
2024-05-07,PROD012,Jilin,9,1008,999
2024-05-08,PROD013,Guangzhou,6,852,846
2024-05-09,PROD017,Shenzhen,4,990,986
2024-05-10,PROD005,Guangzhou,3,616,613
2024-05-11,PROD003,Jilin,4,1317,1313
2024-05-12,PROD018,Guangzhou,4,1175,1171
2024-05-13,PROD015,Guangzhou,8,888,880
2024-05-14,PROD008,Jilin,6,746,740
2024-05-15,PROD010,Jilin,10,641,631
2024-05-16,PROD014,Shanghai,8,818,810
2024-05-17,PROD005,Beijing,6,830,824
2024-05-18,PROD007,Jilin,10,539,529
2024-05-19,PROD015,Jilin,7,1135,1128
2024-05-20,PROD006,Jilin,3,1010,1007
2024-05-21,PROD001,Shanghai,1,1161,1160
2024-05-22,PROD014,Jilin,3,869,866
2024-05-23,PROD018,Beijing,3,1091,1088
2024-05-24,PROD020,Beijing,10,1206,1196
2024-05-25,PROD020,Shanghai,1,600,599
2024-05-26,PROD011,Jilin,4,673,669
2024-05-27,PROD003,Guangzhou,5,1187,1182
2024-05-28,PROD019,Shanghai,7,1223,1216
2024-05-29,PROD014,Shanghai,2,810,808
2024-05-30,PROD001,Beijing,1,536,535
2024-05-31,PROD012,Shenzhen,10,461,451
2024-06-01,PROD018,Shanghai,1,1059,1058
2024-06-02,PROD002,Shenzhen,2,1344,1342
2024-06-03,PROD006,Beijing,1,1035,1034
2024-06-04,PROD005,Shanghai,2,955,953
2024-06-05,PROD003,Shenzhen,4,1162,1158
2024-06-06,PROD014,Shenzhen,4,809,805
2024-06-07,PROD018,Shanghai,4,1058,1054
2024-06-08,PROD013,Shanghai,3,1123,1120
2024-06-09,PROD020,Guangzhou,10,676,666
2024-06-10,PROD019,Shenzhen,5,927,922
2024-06-11,PROD019,Shenzhen,2,922,920
2024-06-12,PROD007,Beijing,2,468,466
2024-06-13,PROD009,Shenzhen,10,709,699
2024-06-14,PROD003,Guangzhou,10,1182,1172
2024-06-15,PROD019,Jilin,4,1034,1030
2024-06-16,PROD007,Shanghai,7,693,686
2024-06-17,PROD004,Shanghai,3,1355,1352
2024-06-18,PROD003,Guangzhou,6,1172,1166
2024-06-19,PROD013,Beijing,6,1212,1206
2024-06-20,PROD011,Jilin,5,669,664
2024-06-21,PROD019,Jilin,5,1030,1025
2024-06-22,PROD009,Beijing,1,694,693
2024-06-23,PROD006,Jilin,5,1007,1002
2024-06-24,PROD012,Jilin,3,999,996
2024-06-25,PROD004,Shenzhen,4,550,546
2024-06-26,PROD014,Shanghai,8,808,800
2024-06-27,PROD020,Jilin,3,1338,1335
2024-06-28,PROD015,Shenzhen,9,950,941
2024-06-29,PROD017,Jilin,10,1252,1242
2024-06-30,PROD003,Shanghai,9,1230,1221
2024-07-01,PROD007,Beijing,3,466,463
2024-07-02,PROD014,Beijing,7,655,648
2024-07-03,PROD005,Shenzhen,6,813,807
2024-07-04,PROD005,Guangzhou,1,613,612
2024-07-05,PROD009,Beijing,8,693,685
2024-07-06,PROD011,Beijing,2,1466,1464
2024-07-07,PROD009,Shanghai,10,689,679
2024-07-08,PROD002,Shenzhen,1,1342,1341
2024-07-09,PROD006,Beijing,10,1034,1024
2024-07-10,PROD020,Shanghai,8,599,591
2024-07-11,PROD008,Shenzhen,10,889,879
2024-07-12,PROD018,Shenzhen,3,1195,1192
2024-07-13,PROD012,Beijing,2,1254,1252
2024-07-14,PROD018,Guangzhou,4,1171,1167
2024-07-15,PROD017,Jilin,5,1242,1237
2024-07-16,PROD020,Guangzhou,3,666,663
2024-07-17,PROD005,Beijing,6,824,818
2024-07-18,PROD019,Guangzhou,10,1311,1301
2024-07-19,PROD009,Shanghai,4,679,675
2024-07-20,PROD004,Shanghai,4,1352,1348
2024-07-21,PROD001,Jilin,6,594,588
2024-07-22,PROD005,Shanghai,6,953,947
2024-07-23,PROD010,Jilin,4,631,627
2024-07-24,PROD014,Shanghai,5,800,795
2024-07-25,PROD017,Guangzhou,3,568,565
2024-07-26,PROD017,Jilin,3,1237,1234
2024-07-27,PROD016,Jilin,8,819,811
2024-07-28,PROD020,Guangzhou,3,663,660
2024-07-29,PROD006,Shenzhen,2,579,577
2024-07-30,PROD010,Shenzhen,8,1050,1042
2024-07-31,PROD018,Guangzhou,1,1167,1166
2024-08-01,PROD004,Shenzhen,2,546,544
2024-08-02,PROD005,Shenzhen,10,807,797
2024-08-03,PROD006,Beijing,5,1024,1019
2024-08-04,PROD001,Beijing,5,535,530
2024-08-05,PROD003,Beijing,4,1423,1419
2024-08-06,PROD005,Beijing,9,818,809
2024-08-07,PROD005,Jilin,10,940,930
2024-08-08,PROD011,Shenzhen,4,1072,1068
2024-08-09,PROD001,Shanghai,1,1160,1159
2024-08-10,PROD013,Shanghai,2,1120,1118
2024-08-11,PROD003,Guangzhou,1,1166,1165
2024-08-12,PROD006,Jilin,2,1002,1000
2024-08-13,PROD020,Guangzhou,10,660,650
2024-08-14,PROD001,Shenzhen,7,772,765
2024-08-15,PROD012,Shanghai,4,940,936
2024-08-16,PROD002,Shanghai,9,677,668
2024-08-17,PROD019,Beijing,4,789,785
2024-08-18,PROD016,Guangzhou,2,515,513
2024-08-19,PROD020,Shanghai,3,591,588
2024-08-20,PROD003,Beijing,2,1419,1417
2024-08-21,PROD010,Beijing,3,1401,1398
2024-08-22,PROD018,Guangzhou,5,1166,1161
2024-08-23,PROD007,Beijing,1,463,462
2024-08-24,PROD009,Beijing,5,685,680
2024-08-25,PROD017,Shanghai,3,896,893
2024-08-26,PROD014,Jilin,7,866,859
2024-08-27,PROD015,Shanghai,3,533,530
2024-08-28,PROD018,Jilin,1,1463,1462
2024-08-29,PROD013,Guangzhou,4,846,842
2024-08-30,PROD004,Guangzhou,10,1391,1381
2024-08-31,PROD019,Jilin,7,1025,1018
2024-09-01,PROD011,Jilin,6,664,658
2024-09-02,PROD009,Jilin,5,592,587
2024-09-03,PROD016,Jilin,8,811,803
2024-09-04,PROD015,Beijing,9,1058,1049
2024-09-05,PROD004,Shanghai,1,1348,1347
2024-09-06,PROD016,Guangzhou,8,513,505
2024-09-07,PROD007,Jilin,3,529,526
2024-09-08,PROD018,Jilin,6,1462,1456
2024-09-09,PROD009,Shenzhen,6,699,693
2024-09-10,PROD019,Shenzhen,2,920,918
2024-09-11,PROD003,Jilin,10,1313,1303
2024-09-12,PROD013,Beijing,7,1206,1199
2024-09-13,PROD017,Shanghai,7,893,886
2024-09-14,PROD001,Jilin,1,588,587
2024-09-15,PROD019,Shanghai,3,1216,1213
2024-09-16,PROD001,Shanghai,3,1159,1156
2024-09-17,PROD008,Guangzhou,6,1424,1418
2024-09-18,PROD001,Shanghai,9,1156,1147
2024-09-19,PROD002,Beijing,3,1070,1067
2024-09-20,PROD019,Jilin,9,1018,1009
2024-09-21,PROD010,Shanghai,8,813,805
2024-09-22,PROD018,Beijing,8,1088,1080
2024-09-23,PROD017,Guangzhou,3,565,562
2024-09-24,PROD008,Guangzhou,7,1418,1411
2024-09-25,PROD011,Beijing,9,1464,1455
2024-09-26,PROD008,Jilin,4,740,736
2024-09-27,PROD011,Guangzhou,2,935,933
2024-09-28,PROD014,Jilin,3,859,856
2024-09-29,PROD020,Jilin,2,1335,1333
2024-09-30,PROD003,Shenzhen,6,1158,1152
2024-10-01,PROD007,Beijing,7,462,455
2024-10-02,PROD004,Shanghai,4,1347,1343
2024-10-03,PROD002,Shanghai,9,668,659
2024-10-04,PROD019,Beijing,8,785,777
2024-10-05,PROD018,Guangzhou,9,1161,1152
2024-10-06,PROD003,Beijing,3,1417,1414
2024-10-07,PROD007,Jilin,4,526,522
2024-10-08,PROD003,Jilin,4,1303,1299
2024-10-09,PROD018,Shanghai,1,1054,1053
2024-10-10,PROD003,Beijing,1,1414,1413
2024-10-11,PROD018,Beijing,8,1080,1072
2024-10-12,PROD019,Beijing,8,777,769
2024-10-13,PROD005,Shenzhen,7,797,790
2024-10-14,PROD008,Guangzhou,2,1411,1409
2024-10-15,PROD007,Shanghai,4,686,682
2024-10-16,PROD007,Jilin,2,522,520
2024-10-17,PROD015,Jilin,4,1128,1124
2024-10-18,PROD008,Beijing,2,648,646
2024-10-19,PROD004,Shanghai,5,1343,1338
2024-10-20,PROD009,Jilin,3,587,584
2024-10-21,PROD014,Jilin,8,856,848
2024-10-22,PROD006,Jilin,6,1000,994
2024-10-23,PROD018,Guangzhou,7,1152,1145
2024-10-24,PROD007,Beijing,7,455,448
2024-10-25,PROD019,Jilin,7,1009,1002
2024-10-26,PROD007,Guangzhou,2,1110,1108
2024-10-27,PROD009,Beijing,10,680,670
2024-10-28,PROD002,Jilin,6,1053,1047
2024-10-29,PROD010,Guangzhou,9,1457,1448
2024-10-30,PROD002,Beijing,6,1067,1061
2024-10-31,PROD014,Beijing,2,648,646
2024-11-01,PROD008,Jilin,5,736,731
2024-11-02,PROD002,Shenzhen,4,1341,1337
2024-11-03,PROD004,Jilin,7,546,539
2024-11-04,PROD010,Shanghai,7,805,798
2024-11-05,PROD005,Beijing,4,809,805
2024-11-06,PROD010,Jilin,2,627,625
2024-11-07,PROD002,Guangzhou,5,1144,1139
2024-11-08,PROD010,Beijing,8,1398,1390
2024-11-09,PROD016,Shanghai,1,1322,1321
2024-11-10,PROD007,Guangzhou,10,1108,1098
2024-11-11,PROD006,Beijing,1,1019,1018
2024-11-12,PROD011,Jilin,10,658,648
2024-11-13,PROD008,Beijing,10,646,636
2024-11-14,PROD001,Shanghai,1,1147,1146
2024-11-15,PROD016,Jilin,1,803,802
2024-11-16,PROD002,Shenzhen,2,1337,1335
2024-11-17,PROD018,Shenzhen,3,1192,1189
2024-11-18,PROD018,Shenzhen,7,1189,1182
2024-11-19,PROD001,Guangzhou,8,1237,1229
2024-11-20,PROD020,Shenzhen,9,1244,1235
2024-11-21,PROD012,Shenzhen,10,451,441
2024-11-22,PROD016,Guangzhou,4,505,501
2024-11-23,PROD009,Beijing,6,670,664
2024-11-24,PROD009,Guangzhou,10,1332,1322
2024-11-25,PROD001,Shanghai,7,1146,1139
2024-11-26,PROD015,Shanghai,3,530,527
2024-11-27,PROD013,Guangzhou,9,842,833
2024-11-28,PROD008,Shenzhen,8,879,871
2024-11-29,PROD001,Shenzhen,3,765,762
2024-11-30,PROD012,Jilin,4,996,992
2024-12-01,PROD011,Shenzhen,1,1068,1067
2024-12-02,PROD020,Guangzhou,2,650,648
2024-12-03,PROD019,Shanghai,9,1213,1204
2024-12-04,PROD010,Guangzhou,10,1448,1438
2024-12-05,PROD006,Jilin,6,994,988
2024-12-06,PROD019,Shenzhen,9,918,909
2024-12-07,PROD018,Beijing,4,1072,1068
2024-12-08,PROD011,Shanghai,4,753,749
2024-12-09,PROD015,Jilin,4,1124,1120
2024-12-10,PROD014,Shenzhen,10,805,795
2024-12-11,PROD016,Shanghai,3,1321,1318
2024-12-12,PROD001,Guangzhou,6,1229,1223
2024-12-13,PROD014,Beijing,10,646,636
2024-12-14,PROD013,Jilin,10,974,964
2024-12-15,PROD009,Beijing,5,664,659
2024-12-16,PROD015,Guangzhou,7,880,873
2024-12-17,PROD005,Shenzhen,4,790,786
2024-12-18,PROD019,Beijing,6,769,763
2024-12-19,PROD016,Jilin,1,802,801
2024-12-20,PROD020,Shenzhen,10,1235,1225
2024-12-21,PROD008,Beijing,2,636,634
2024-12-22,PROD010,Jilin,8,625,617
2024-12-23,PROD008,Shenzhen,9,871,862
2024-12-24,PROD020,Jilin,3,1333,1330
2024-12-25,PROD014,Guangzhou,5,549,544
2024-12-26,PROD013,Shanghai,2,1118,1116
2024-12-27,PROD008,Guangzhou,3,1409,1406
2024-12-28,PROD003,Guangzhou,8,1165,1157
2024-12-29,PROD018,Jilin,1,1456,1455
2024-12-30,PROD020,Jilin,9,1330,1321
2024-01-01,PROD016,Shanghai,1,1318,1317
2024-01-02,PROD009,Shanghai,2,675,673
2024-01-03,PROD011,Jilin,3,648,645
2024-01-04,PROD012,Shenzhen,2,441,439
2024-01-05,PROD008,Shenzhen,5,862,857
2024-01-06,PROD015,Jilin,8,1120,1112
2024-01-07,PROD006,Beijing,2,1018,1016
2024-01-08,PROD019,Beijing,8,763,755
2024-01-09,PROD020,Shanghai,3,588,585
2024-01-10,PROD007,Shenzhen,3,758,755
2024-01-11,PROD020,Shanghai,8,585,577
2024-01-12,PROD001,Beijing,8,530,522
2024-01-13,PROD020,Shanghai,4,577,573
2024-01-14,PROD005,Guangzhou,7,612,605
2024-01-15,PROD018,Shanghai,1,1053,1052
2024-01-16,PROD004,Shenzhen,10,544,534
2024-01-17,PROD017,Guangzhou,5,562,557
2024-01-18,PROD005,Shanghai,8,947,939
2024-01-19,PROD011,Jilin,8,645,637
2024-01-20,PROD009,Guangzhou,9,1322,1313
2024-01-21,PROD009,Shanghai,8,673,665
2024-01-22,PROD011,Guangzhou,1,933,932
2024-01-23,PROD005,Shanghai,9,939,930
2024-01-24,PROD013,Guangzhou,8,833,825
2024-01-25,PROD011,Jilin,6,637,631
2024-01-26,PROD016,Shenzhen,2,529,527
2024-01-27,PROD015,Jilin,5,1112,1107
2024-01-28,PROD003,Guangzhou,5,1157,1152
2024-01-29,PROD007,Shenzhen,3,755,752
2024-01-30,PROD016,Shanghai,3,1317,1314
2024-01-31,PROD003,Shenzhen,1,1152,1151
2024-02-01,PROD007,Guangzhou,1,1098,1097
2024-02-02,PROD015,Shanghai,6,527,521
2024-02-03,PROD001,Shenzhen,5,762,757
2024-02-04,PROD013,Shenzhen,4,1323,1319
2024-02-05,PROD016,Shanghai,6,1314,1308
2024-02-06,PROD009,Beijing,7,659,652
2024-02-07,PROD001,Guangzhou,2,1223,1221
2024-02-08,PROD007,Shenzhen,6,752,746
2024-02-09,PROD007,Beijing,1,448,447
2024-02-10,PROD005,Guangzhou,6,605,599
2024-02-11,PROD012,Beijing,1,1252,1251
2024-02-12,PROD002,Jilin,7,1047,1040
2024-02-13,PROD005,Shanghai,8,930,922
2024-02-14,PROD019,Shenzhen,10,909,899
2024-02-15,PROD001,Shanghai,7,1139,1132
2024-02-16,PROD001,Shenzhen,9,757,748
2024-02-17,PROD014,Shenzhen,10,795,785
2024-02-18,PROD008,Beijing,2,634,632
2024-02-19,PROD019,Beijing,8,755,747
2024-02-20,PROD011,Guangzhou,2,932,930
2024-02-21,PROD012,Shanghai,7,936,929
2024-02-22,PROD004,Shanghai,8,1338,1330
2024-02-23,PROD015,Shenzhen,2,941,939
2024-02-24,PROD007,Beijing,4,447,443
2024-02-25,PROD018,Shanghai,5,1052,1047
2024-02-26,PROD015,Shanghai,8,521,513
2024-02-27,PROD015,Guangzhou,3,873,870
2024-02-28,PROD009,Jilin,9,584,575
2024-02-29,PROD014,Beijing,8,636,628
2024-03-01,PROD001,Shanghai,4,1132,1128
2024-03-02,PROD009,Guangzhou,6,1313,1307
2024-03-03,PROD001,Shanghai,5,1128,1123
2024-03-04,PROD006,Guangzhou,6,1360,1354
2024-03-05,PROD003,Beijing,1,1413,1412
2024-03-06,PROD012,Shanghai,2,929,927
2024-03-07,PROD003,Beijing,4,1412,1408
2024-03-08,PROD003,Guangzhou,6,1152,1146
2024-03-09,PROD001,Beijing,10,522,512
2024-03-10,PROD001,Shenzhen,9,748,739
2024-03-11,PROD006,Jilin,1,988,987
2024-03-12,PROD010,Beijing,2,1390,1388
2024-03-13,PROD016,Shanghai,3,1308,1305
2024-03-14,PROD008,Guangzhou,3,1406,1403
2024-03-15,PROD017,Shenzhen,8,986,978
2024-03-16,PROD008,Beijing,5,632,627
2024-03-17,PROD020,Beijing,1,1196,1195
2024-03-18,PROD008,Shanghai,8,572,564
2024-03-19,PROD015,Shenzhen,2,939,937
2024-03-20,PROD019,Guangzhou,9,1301,1292
2024-03-21,PROD003,Guangzhou,7,1146,1139
2024-03-22,PROD009,Guangzhou,10,1307,1297
2024-03-23,PROD015,Beijing,3,1049,1046
2024-03-24,PROD006,Shenzhen,6,577,571
2024-03-25,PROD019,Guangzhou,7,1292,1285
2024-03-26,PROD014,Jilin,4,848,844
2024-03-27,PROD011,Guangzhou,7,930,923
2024-03-28,PROD011,Jilin,2,631,629
2024-03-29,PROD005,Beijing,2,805,803
2024-03-30,PROD019,Shanghai,5,1204,1199
2024-03-31,PROD003,Shenzhen,3,1151,1148
2024-04-01,PROD010,Shanghai,6,798,792
2024-04-02,PROD015,Beijing,5,1046,1041
2024-04-03,PROD020,Shanghai,1,573,572
2024-04-04,PROD001,Beijing,5,512,507
2024-04-05,PROD010,Beijing,1,1388,1387
2024-04-06,PROD002,Beijing,4,1061,1057
2024-04-07,PROD015,Guangzhou,7,870,863
2024-04-08,PROD013,Shenzhen,4,1319,1315
2024-04-09,PROD005,Shanghai,5,922,917
2024-04-10,PROD014,Beijing,5,628,623
2024-04-11,PROD011,Beijing,4,1455,1451
2024-04-12,PROD012,Guangzhou,1,577,576
2024-04-13,PROD010,Guangzhou,10,1438,1428
2024-04-14,PROD010,Jilin,9,617,608
2024-04-15,PROD014,Jilin,6,844,838
2024-04-16,PROD013,Beijing,9,1199,1190
2024-04-17,PROD008,Jilin,9,731,722
2024-04-18,PROD001,Beijing,2,507,505
2024-04-19,PROD015,Shanghai,8,513,505
2024-04-20,PROD009,Shanghai,3,665,662
2024-04-21,PROD010,Guangzhou,1,1428,1427
2024-04-22,PROD006,Shanghai,1,564,563
2024-04-23,PROD016,Beijing,3,1287,1284
2024-04-24,PROD001,Beijing,3,505,502
2024-04-25,PROD004,Shenzhen,6,534,528
2024-04-26,PROD006,Guangzhou,2,1354,1352
2024-04-27,PROD006,Beijing,8,1016,1008
2024-04-28,PROD008,Shenzhen,9,857,848
2024-04-29,PROD016,Guangzhou,5,501,496
2024-04-30,PROD007,Jilin,6,520,514
2024-05-01,PROD014,Beijing,7,623,616
2024-05-02,PROD012,Beijing,8,1251,1243
2024-05-03,PROD004,Jilin,4,539,535
2024-05-04,PROD017,Guangzhou,7,557,550
2024-05-05,PROD001,Guangzhou,7,1221,1214
2024-05-06,PROD006,Beijing,9,1008,999
2024-05-07,PROD011,Shenzhen,10,1067,1057
2024-05-08,PROD019,Shanghai,6,1199,1193
2024-05-09,PROD011,Shenzhen,7,1057,1050
2024-05-10,PROD012,Shanghai,8,927,919
2024-05-11,PROD004,Shenzhen,10,528,518
2024-05-12,PROD005,Beijing,2,803,801
2024-05-13,PROD008,Guangzhou,9,1403,1394
2024-05-14,PROD015,Shenzhen,4,937,933
2024-05-15,PROD012,Guangzhou,6,576,570
2024-05-16,PROD012,Shenzhen,9,439,430
2024-05-17,PROD020,Jilin,7,1321,1314
2024-05-18,PROD017,Shenzhen,8,978,970
2024-05-19,PROD011,Jilin,2,629,627
2024-05-20,PROD007,Jilin,1,514,513
2024-05-21,PROD015,Beijing,1,1041,1040
2024-05-22,PROD009,Shenzhen,5,693,688
2024-05-23,PROD018,Shenzhen,7,1182,1175
2024-05-24,PROD004,Jilin,9,535,526
2024-05-25,PROD011,Beijing,4,1451,1447
2024-05-26,PROD004,Jilin,10,526,516
2024-05-27,PROD001,Shanghai,3,1123,1120
2024-05-28,PROD019,Guangzhou,7,1285,1278
2024-05-29,PROD008,Jilin,1,722,721
2024-05-30,PROD002,Guangzhou,8,1139,1131
2024-05-31,PROD014,Guangzhou,6,544,538
2024-06-01,PROD012,Beijing,5,1243,1238
2024-06-02,PROD007,Jilin,6,513,507
2024-06-03,PROD003,Shenzhen,3,1148,1145
2024-06-04,PROD005,Shanghai,5,917,912
2024-06-05,PROD018,Jilin,5,1455,1450
2024-06-06,PROD008,Shenzhen,3,848,845
2024-06-07,PROD007,Guangzhou,10,1097,1087
2024-06-08,PROD017,Shanghai,10,886,876
2024-06-09,PROD006,Beijing,1,999,998
2024-06-10,PROD007,Jilin,6,507,501
2024-06-11,PROD017,Jilin,10,1234,1224
2024-06-12,PROD014,Guangzhou,9,538,529
2024-06-13,PROD004,Beijing,2,889,887
2024-06-14,PROD017,Shanghai,4,876,872
2024-06-15,PROD013,Shanghai,8,1116,1108
2024-06-16,PROD013,Guangzhou,2,825,823
2024-06-17,PROD009,Beijing,9,652,643
2024-06-18,PROD009,Guangzhou,5,1297,1292
2024-06-19,PROD008,Jilin,10,721,711
2024-06-20,PROD007,Jilin,3,501,498
2024-06-21,PROD017,Beijing,1,1273,1272
2024-06-22,PROD019,Shenzhen,5,899,894
2024-06-23,PROD017,Shenzhen,2,970,968
2024-06-24,PROD008,Shenzhen,3,845,842
2024-06-25,PROD018,Guangzhou,1,1145,1144
2024-06-26,PROD002,Shanghai,10,659,649
2024-06-27,PROD005,Beijing,5,801,796
2024-06-28,PROD019,Guangzhou,1,1278,1277
2024-06-29,PROD020,Guangzhou,3,648,645
2024-06-30,PROD013,Shanghai,6,1108,1102
2024-07-01,PROD020,Shanghai,6,572,566
2024-07-02,PROD004,Beijing,7,887,880
2024-07-03,PROD013,Shenzhen,10,1315,1305
2024-07-04,PROD019,Shanghai,3,1193,1190
2024-07-05,PROD010,Guangzhou,6,1427,1421
2024-07-06,PROD007,Guangzhou,7,1087,1080
2024-07-07,PROD018,Shanghai,4,1047,1043
2024-07-08,PROD012,Guangzhou,9,570,561
2024-07-09,PROD002,Beijing,1,1057,1056
2024-07-10,PROD010,Shanghai,3,792,789
2024-07-11,PROD018,Shenzhen,4,1175,1171
2024-07-12,PROD001,Beijing,10,502,492
2024-07-13,PROD008,Shenzhen,7,842,835
2024-07-14,PROD012,Guangzhou,2,561,559
2024-07-15,PROD006,Shanghai,2,563,561
2024-07-16,PROD020,Jilin,3,1314,1311
2024-07-17,PROD014,Guangzhou,7,529,522
2024-07-18,PROD002,Shenzhen,7,1335,1328
2024-07-19,PROD006,Beijing,10,998,988
2024-07-20,PROD010,Shenzhen,4,1042,1038
2024-07-21,PROD015,Jilin,1,1107,1106
2024-07-22,PROD015,Shenzhen,8,933,925
2024-07-23,PROD014,Shanghai,3,795,792
2024-07-24,PROD008,Jilin,3,711,708
2024-07-25,PROD008,Shanghai,9,564,555
2024-07-26,PROD011,Shenzhen,6,1050,1044
2024-07-27,PROD019,Shanghai,9,1190,1181
2024-07-28,PROD020,Beijing,10,1195,1185
2024-07-29,PROD001,Shenzhen,2,739,737
2024-07-30,PROD014,Shanghai,7,792,785
2024-07-31,PROD002,Shanghai,7,649,642
2024-08-01,PROD005,Shenzhen,2,786,784
2024-08-02,PROD020,Beijing,9,1185,1176
2024-08-03,PROD003,Beijing,6,1408,1402
2024-08-04,PROD012,Shenzhen,8,430,422
2024-08-05,PROD009,Shenzhen,2,688,686
2024-08-06,PROD004,Jilin,1,516,515
2024-08-07,PROD006,Jilin,3,987,984
2024-08-08,PROD015,Shanghai,7,505,498
2024-08-09,PROD020,Guangzhou,7,645,638
2024-08-10,PROD003,Shanghai,1,1221,1220
2024-08-11,PROD019,Guangzhou,2,1277,1275
2024-08-12,PROD016,Shenzhen,3,527,524
2024-08-13,PROD019,Shanghai,5,1181,1176
2024-08-14,PROD009,Shanghai,7,662,655
2024-08-15,PROD002,Jilin,6,1040,1034
2024-08-16,PROD002,Shanghai,8,642,634
2024-08-17,PROD008,Jilin,6,708,702
2024-08-18,PROD008,Guangzhou,3,1394,1391
2024-08-19,PROD019,Guangzhou,1,1275,1274
2024-08-20,PROD006,Shanghai,1,561,560
2024-08-21,PROD015,Shenzhen,1,925,924
2024-08-22,PROD009,Guangzhou,2,1292,1290
2024-08-23,PROD006,Shanghai,8,560,552
2024-08-24,PROD010,Shenzhen,5,1038,1033
2024-08-25,PROD008,Jilin,10,702,692
2024-08-26,PROD019,Beijing,6,747,741
2024-08-27,PROD013,Shenzhen,3,1305,1302
2024-08-28,PROD007,Shanghai,7,682,675
2024-08-29,PROD005,Guangzhou,6,599,593
2024-08-30,PROD014,Shanghai,7,785,778
2024-08-31,PROD017,Shanghai,3,872,869
2024-09-01,PROD010,Shanghai,5,789,784
2024-09-02,PROD007,Shenzhen,1,746,745
2024-09-03,PROD002,Shenzhen,4,1328,1324
2024-09-04,PROD005,Jilin,4,930,926
2024-09-05,PROD013,Shenzhen,2,1302,1300
2024-09-06,PROD014,Shanghai,5,778,773
2024-09-07,PROD019,Jilin,8,1002,994
2024-09-08,PROD001,Shanghai,8,1120,1112
2024-09-09,PROD014,Jilin,6,838,832
2024-09-10,PROD005,Shanghai,10,912,902
2024-09-11,PROD013,Beijing,1,1190,1189
2024-09-12,PROD012,Shanghai,1,919,918
2024-09-13,PROD004,Shenzhen,2,518,516
2024-09-14,PROD014,Jilin,8,832,824
2024-09-15,PROD019,Shenzhen,3,894,891
2024-09-16,PROD005,Jilin,3,926,923
2024-09-17,PROD012,Guangzhou,5,559,554
2024-09-18,PROD012,Shanghai,9,918,909
2024-09-19,PROD014,Shanghai,6,773,767
2024-09-20,PROD007,Shenzhen,7,745,738
2024-09-21,PROD019,Shanghai,9,1176,1167
2024-09-22,PROD011,Jilin,8,627,619
2024-09-23,PROD002,Beijing,2,1056,1054
2024-09-24,PROD008,Beijing,2,627,625
2024-09-25,PROD003,Guangzhou,7,1139,1132
2024-09-26,PROD010,Guangzhou,9,1421,1412
2024-09-27,PROD012,Beijing,5,1238,1233
2024-09-28,PROD009,Guangzhou,7,1290,1283
2024-09-29,PROD013,Jilin,1,964,963
2024-09-30,PROD016,Beijing,8,1284,1276
2024-10-01,PROD013,Shanghai,1,1102,1101
2024-10-02,PROD002,Shanghai,10,634,624
2024-10-03,PROD017,Jilin,3,1224,1221
2024-10-04,PROD003,Jilin,10,1299,1289
2024-10-05,PROD013,Jilin,2,963,961
2024-10-06,PROD005,Beijing,5,796,791
2024-10-07,PROD007,Guangzhou,9,1080,1071
2024-10-08,PROD008,Jilin,8,692,684
2024-10-09,PROD005,Jilin,7,923,916
2024-10-10,PROD005,Jilin,3,916,913
2024-10-11,PROD010,Beijing,4,1387,1383
2024-10-12,PROD004,Beijing,8,880,872
2024-10-13,PROD019,Guangzhou,2,1274,1272
2024-10-14,PROD009,Shanghai,1,655,654
2024-10-15,PROD004,Beijing,2,872,870
2024-10-16,PROD016,Shenzhen,6,524,518
2024-10-17,PROD014,Guangzhou,1,522,521
2024-10-18,PROD002,Beijing,1,1054,1053
2024-10-19,PROD020,Shanghai,4,566,562
2024-10-20,PROD018,Shanghai,10,1043,1033
2024-10-21,PROD014,Guangzhou,1,521,520
2024-10-22,PROD006,Jilin,3,984,981
2024-10-23,PROD017,Beijing,6,1272,1266
2024-10-24,PROD008,Jilin,2,684,682
2024-10-25,PROD016,Beijing,5,1276,1271
2024-10-26,PROD015,Shenzhen,9,924,915
2024-10-27,PROD007,Guangzhou,1,1071,1070
2024-10-28,PROD014,Guangzhou,10,520,510
2024-10-29,PROD018,Shenzhen,7,1171,1164
2024-10-30,PROD003,Guangzhou,1,1132,1131
2024-10-31,PROD011,Shanghai,2,749,747
2024-11-01,PROD017,Guangzhou,1,550,549
2024-11-02,PROD009,Shanghai,3,654,651
2024-11-03,PROD014,Shanghai,2,767,765
2024-11-04,PROD010,Shenzhen,3,1033,1030
2024-11-05,PROD018,Beijing,4,1068,1064
2024-11-06,PROD005,Guangzhou,2,593,591
2024-11-07,PROD002,Guangzhou,8,1131,1123
2024-11-08,PROD008,Jilin,3,682,679
2024-11-09,PROD005,Shenzhen,9,784,775
2024-11-10,PROD014,Shanghai,9,765,756
2024-11-11,PROD008,Beijing,10,625,615
2024-11-12,PROD002,Jilin,10,1034,1024
2024-11-13,PROD001,Shenzhen,6,737,731
2024-11-14,PROD004,Beijing,1,870,869
2024-11-15,PROD008,Jilin,6,679,673
2024-11-16,PROD007,Beijing,2,443,441
2024-11-17,PROD018,Guangzhou,10,1144,1134
2024-11-18,PROD018,Jilin,7,1450,1443
2024-11-19,PROD012,Shanghai,9,909,900
2024-11-20,PROD013,Shanghai,9,1101,1092
2024-11-21,PROD017,Shenzhen,10,968,958
2024-11-22,PROD004,Guangzhou,3,1381,1378
2024-11-23,PROD012,Shenzhen,8,422,414
2024-11-24,PROD005,Shenzhen,3,775,772
2024-11-25,PROD007,Jilin,8,498,490
2024-11-26,PROD002,Beijing,10,1053,1043
2024-11-27,PROD016,Beijing,9,1271,1262
2024-11-28,PROD017,Beijing,7,1266,1259
2024-11-29,PROD011,Shanghai,5,747,742
2024-11-30,PROD011,Shenzhen,9,1044,1035
2024-12-01,PROD003,Beijing,2,1402,1400
2024-12-02,PROD010,Shanghai,9,784,775
2024-12-03,PROD013,Beijing,7,1189,1182
2024-12-04,PROD005,Beijing,1,791,790
2024-12-05,PROD018,Shenzhen,8,1164,1156
2024-12-06,PROD010,Jilin,2,608,606
2024-12-07,PROD010,Guangzhou,3,1412,1409
2024-12-08,PROD012,Guangzhou,10,554,544
2024-12-09,PROD014,Shanghai,4,756,752
2024-12-10,PROD009,Beijing,6,643,637
2024-12-11,PROD019,Beijing,3,741,738
2024-12-12,PROD001,Shanghai,8,1112,1104
2024-12-13,PROD008,Guangzhou,2,1391,1389
2024-12-14,PROD001,Shenzhen,1,731,730
2024-12-15,PROD005,Jilin,10,913,903
2024-12-16,PROD019,Shenzhen,6,891,885
2024-12-17,PROD012,Shenzhen,8,414,406
2024-12-18,PROD011,Jilin,9,619,610
2024-12-19,PROD002,Guangzhou,7,1123,1116
2024-12-20,PROD005,Shenzhen,5,772,767
2024-12-21,PROD010,Shanghai,5,775,770
2024-12-22,PROD005,Shenzhen,8,767,759
2024-12-23,PROD018,Guangzhou,4,1134,1130
2024-12-24,PROD010,Shenzhen,9,1030,1021
2024-12-25,PROD015,Shanghai,10,498,488
2024-12-26,PROD019,Shanghai,3,1167,1164
2024-12-27,PROD014,Jilin,9,824,815
2024-12-28,PROD006,Beijing,1,988,987
2024-12-29,PROD006,Guangzhou,2,1352,1350
2024-12-30,PROD020,Jilin,4,1311,1307
2024-01-01,PROD010,Shanghai,8,770,762
2024-01-02,PROD010,Shanghai,8,762,754
2024-01-03,PROD008,Jilin,3,673,670
2024-01-04,PROD020,Jilin,6,1307,1301
2024-01-05,PROD013,Shanghai,5,1092,1087
2024-01-06,PROD012,Beijing,5,1233,1228
2024-01-07,PROD005,Shenzhen,9,759,750
2024-01-08,PROD010,Shanghai,4,754,750
2024-01-09,PROD001,Guangzhou,6,1214,1208
2024-01-10,PROD010,Beijing,4,1383,1379
2024-01-11,PROD010,Guangzhou,6,1409,1403
2024-01-12,PROD016,Shenzhen,8,518,510
2024-01-13,PROD016,Jilin,6,801,795
2024-01-14,PROD006,Guangzhou,2,1350,1348
2024-01-15,PROD011,Guangzhou,1,923,922
2024-01-16,PROD008,Beijing,2,615,613
2024-01-17,PROD002,Shenzhen,10,1324,1314
2024-01-18,PROD018,Beijing,9,1064,1055
2024-01-19,PROD009,Jilin,5,575,570
2024-01-20,PROD007,Shanghai,2,675,673
2024-01-21,PROD011,Shanghai,2,742,740
2024-01-22,PROD008,Jilin,9,670,661
2024-01-23,PROD001,Beijing,3,492,489
2024-01-24,PROD001,Guangzhou,1,1208,1207
2024-01-25,PROD020,Shenzhen,3,1225,1222
2024-01-26,PROD005,Shenzhen,6,750,744
2024-01-27,PROD004,Guangzhou,8,1378,1370
2024-01-28,PROD020,Beijing,9,1176,1167
2024-01-29,PROD002,Jilin,5,1024,1019
2024-01-30,PROD011,Shenzhen,2,1035,1033
2024-01-31,PROD012,Beijing,4,1228,1224
2024-02-01,PROD006,Guangzhou,2,1348,1346
2024-02-02,PROD014,Jilin,8,815,807
2024-02-03,PROD016,Shenzhen,5,510,505
2024-02-04,PROD010,Shanghai,4,750,746
2024-02-05,PROD013,Guangzhou,10,823,813
2024-02-06,PROD020,Beijing,3,1167,1164
2024-02-07,PROD014,Beijing,5,616,611
2024-02-08,PROD018,Beijing,9,1055,1046
2024-02-09,PROD016,Guangzhou,8,496,488
2024-02-10,PROD013,Beijing,9,1182,1173
2024-02-11,PROD016,Shenzhen,10,505,495
2024-02-12,PROD003,Beijing,8,1400,1392
2024-02-13,PROD012,Beijing,10,1224,1214
2024-02-14,PROD006,Shenzhen,7,571,564
2024-02-15,PROD009,Shenzhen,4,686,682
2024-02-16,PROD015,Guangzhou,4,863,859
2024-02-17,PROD002,Beijing,10,1043,1033
2024-02-18,PROD015,Beijing,9,1040,1031
2024-02-19,PROD016,Guangzhou,8,488,480
2024-02-20,PROD003,Shanghai,9,1220,1211
2024-02-21,PROD006,Shanghai,3,552,549
2024-02-22,PROD002,Beijing,3,1033,1030
2024-02-23,PROD020,Beijing,9,1164,1155
2024-02-24,PROD003,Beijing,4,1392,1388
2024-02-25,PROD008,Shenzhen,8,835,827
2024-02-26,PROD014,Shanghai,4,752,748
2024-02-27,PROD004,Jilin,2,515,513
2024-02-28,PROD019,Guangzhou,9,1272,1263
2024-02-29,PROD013,Shanghai,2,1087,1085
2024-03-01,PROD008,Shenzhen,6,827,821
2024-03-02,PROD019,Shanghai,10,1164,1154
2024-03-03,PROD004,Guangzhou,3,1370,1367
2024-03-04,PROD006,Shanghai,1,549,548
2024-03-05,PROD005,Beijing,8,790,782
2024-03-06,PROD005,Shanghai,1,902,901
2024-03-07,PROD004,Beijing,5,869,864
2024-03-08,PROD005,Jilin,9,903,894
2024-03-09,PROD008,Guangzhou,3,1389,1386
2024-03-10,PROD007,Shanghai,1,673,672
2024-03-11,PROD014,Shenzhen,5,785,780
2024-03-12,PROD008,Beijing,6,613,607
2024-03-13,PROD008,Shenzhen,1,821,820
2024-03-14,PROD006,Shenzhen,10,564,554
2024-03-15,PROD011,Shenzhen,1,1033,1032
2024-03-16,PROD006,Guangzhou,2,1346,1344
2024-03-17,PROD012,Jilin,2,992,990
2024-03-18,PROD014,Guangzhou,4,510,506
2024-03-19,PROD020,Shanghai,2,562,560
2024-03-20,PROD013,Guangzhou,4,813,809
2024-03-21,PROD002,Guangzhou,2,1116,1114
2024-03-22,PROD008,Shanghai,2,555,553
2024-03-23,PROD002,Beijing,10,1030,1020
2024-03-24,PROD017,Shenzhen,1,958,957
2024-03-25,PROD020,Shenzhen,3,1222,1219
2024-03-26,PROD010,Jilin,7,606,599
2024-03-27,PROD003,Beijing,6,1388,1382
2024-03-28,PROD014,Shanghai,7,748,741
2024-03-29,PROD002,Guangzhou,9,1114,1105
2024-03-30,PROD006,Guangzhou,5,1344,1339
2024-03-31,PROD011,Shenzhen,5,1032,1027
2024-04-01,PROD004,Jilin,9,513,504
2024-04-02,PROD011,Guangzhou,9,922,913
2024-04-03,PROD004,Shanghai,5,1330,1325
2024-04-04,PROD007,Shenzhen,7,738,731
2024-04-05,PROD009,Beijing,2,637,635
2024-04-06,PROD012,Beijing,9,1214,1205
2024-04-07,PROD019,Beijing,6,738,732
2024-04-08,PROD019,Shenzhen,7,885,878
2024-04-09,PROD006,Shanghai,4,548,544
2024-04-10,PROD005,Shenzhen,8,744,736
2024-04-11,PROD003,Guangzhou,2,1131,1129
2024-04-12,PROD011,Shenzhen,7,1027,1020
2024-04-13,PROD014,Shanghai,1,741,740
2024-04-14,PROD006,Shenzhen,5,554,549
2024-04-15,PROD018,Beijing,8,1046,1038
2024-04-16,PROD014,Beijing,5,611,606
2024-04-17,PROD013,Beijing,8,1173,1165
2024-04-18,PROD002,Shenzhen,9,1314,1305
2024-04-19,PROD002,Jilin,4,1019,1015
2024-04-20,PROD002,Beijing,3,1020,1017
2024-04-21,PROD006,Shanghai,7,544,537
2024-04-22,PROD017,Beijing,1,1259,1258
2024-04-23,PROD003,Jilin,9,1289,1280
2024-04-24,PROD003,Shanghai,8,1211,1203
2024-04-25,PROD003,Shanghai,9,1203,1194
2024-04-26,PROD016,Shanghai,10,1305,1295
2024-04-27,PROD006,Shanghai,7,537,530
2024-04-28,PROD020,Jilin,10,1301,1291
2024-04-29,PROD003,Shenzhen,5,1145,1140
2024-04-30,PROD013,Guangzhou,2,809,807
2024-05-01,PROD009,Guangzhou,10,1283,1273
2024-05-02,PROD014,Guangzhou,10,506,496
2024-05-03,PROD013,Shanghai,9,1085,1076
2024-05-04,PROD002,Guangzhou,3,1105,1102
2024-05-05,PROD016,Jilin,2,795,793
2024-05-06,PROD010,Shenzhen,4,1021,1017
2024-05-07,PROD013,Shenzhen,5,1300,1295
2024-05-08,PROD015,Jilin,1,1106,1105
2024-05-09,PROD006,Jilin,4,981,977
2024-05-10,PROD008,Shenzhen,5,820,815
2024-05-11,PROD014,Guangzhou,3,496,493
2024-05-12,PROD008,Beijing,1,607,606
2024-05-13,PROD016,Guangzhou,1,480,479
2024-05-14,PROD006,Shanghai,5,530,525
2024-05-15,PROD002,Shenzhen,1,1305,1304
2024-05-16,PROD007,Beijing,1,441,440
2024-05-17,PROD012,Jilin,9,990,981
2024-05-18,PROD011,Guangzhou,6,913,907
2024-05-19,PROD009,Guangzhou,9,1273,1264
2024-05-20,PROD017,Jilin,4,1221,1217
2024-05-21,PROD012,Shanghai,9,900,891
2024-05-22,PROD016,Shanghai,6,1295,1289
2024-05-23,PROD017,Jilin,10,1217,1207
2024-05-24,PROD014,Shenzhen,3,780,777
2024-05-25,PROD008,Beijing,10,606,596
2024-05-26,PROD006,Shanghai,3,525,522
2024-05-27,PROD005,Shenzhen,7,736,729
2024-05-28,PROD010,Shenzhen,7,1017,1010
2024-05-29,PROD018,Shanghai,8,1033,1025
2024-05-30,PROD018,Beijing,3,1038,1035
2024-05-31,PROD006,Shenzhen,5,549,544
2024-06-01,PROD005,Beijing,2,782,780
2024-06-02,PROD010,Beijing,3,1379,1376
2024-06-03,PROD009,Beijing,10,635,625
2024-06-04,PROD010,Shanghai,10,746,736
2024-06-05,PROD002,Shanghai,6,624,618
2024-06-06,PROD001,Shenzhen,2,730,728
2024-06-07,PROD005,Shanghai,6,901,895
2024-06-08,PROD014,Guangzhou,4,493,489
2024-06-09,PROD011,Jilin,4,610,606
2024-06-10,PROD007,Shanghai,8,672,664
2024-06-11,PROD008,Beijing,7,596,589
2024-06-12,PROD016,Beijing,4,1262,1258
2024-06-13,PROD020,Guangzhou,9,638,629
2024-06-14,PROD015,Jilin,2,1105,1103
2024-06-15,PROD005,Guangzhou,6,591,585
2024-06-16,PROD013,Beijing,10,1165,1155
2024-06-17,PROD010,Shenzhen,6,1010,1004
2024-06-18,PROD018,Jilin,2,1443,1441
2024-06-19,PROD018,Guangzhou,7,1130,1123
2024-06-20,PROD019,Shenzhen,5,878,873
2024-06-21,PROD004,Shanghai,8,1325,1317
2024-06-22,PROD020,Shenzhen,7,1219,1212
2024-06-23,PROD008,Beijing,10,589,579
2024-06-24,PROD013,Jilin,8,961,953
2024-06-25,PROD020,Jilin,6,1291,1285
2024-06-26,PROD017,Beijing,7,1258,1251
2024-06-27,PROD007,Jilin,2,490,488
2024-06-28,PROD001,Guangzhou,3,1207,1204
2024-06-29,PROD003,Shenzhen,4,1140,1136
2024-06-30,PROD017,Shanghai,3,869,866
2024-07-01,PROD013,Beijing,6,1155,1149
2024-07-02,PROD012,Beijing,1,1205,1204
2024-07-03,PROD015,Beijing,4,1031,1027
2024-07-04,PROD012,Jilin,9,981,972
2024-07-05,PROD009,Guangzhou,4,1264,1260
2024-07-06,PROD012,Shenzhen,3,406,403
2024-07-07,PROD012,Beijing,1,1204,1203
2024-07-08,PROD014,Guangzhou,8,489,481
2024-07-09,PROD015,Shenzhen,5,915,910
2024-07-10,PROD016,Guangzhou,4,479,475
2024-07-11,PROD008,Shanghai,5,553,548
2024-07-12,PROD003,Guangzhou,5,1129,1124
2024-07-13,PROD014,Shenzhen,8,777,769
2024-07-14,PROD005,Jilin,2,894,892
2024-07-15,PROD009,Beijing,5,625,620
2024-07-16,PROD008,Shanghai,4,548,544
2024-07-17,PROD008,Guangzhou,8,1386,1378
2024-07-18,PROD012,Jilin,5,972,967
2024-07-19,PROD018,Guangzhou,6,1123,1117
2024-07-20,PROD017,Guangzhou,8,549,541
2024-07-21,PROD017,Shenzhen,7,957,950
2024-07-22,PROD001,Shenzhen,10,728,718
2024-07-23,PROD014,Jilin,9,807,798
2024-07-24,PROD015,Beijing,6,1027,1021
2024-07-25,PROD020,Shenzhen,1,1212,1211
2024-07-26,PROD001,Shanghai,4,1104,1100
2024-07-27,PROD008,Guangzhou,7,1378,1371
2024-07-28,PROD002,Beijing,7,1017,1010
2024-07-29,PROD007,Guangzhou,1,1070,1069
2024-07-30,PROD007,Shenzhen,8,731,723
2024-07-31,PROD007,Guangzhou,9,1069,1060
2024-08-01,PROD010,Jilin,9,599,590
2024-08-02,PROD008,Shenzhen,7,815,808
2024-08-03,PROD011,Guangzhou,9,907,898
2024-08-04,PROD007,Jilin,4,488,484
2024-08-05,PROD005,Shanghai,2,895,893
2024-08-06,PROD007,Guangzhou,1,1060,1059
2024-08-07,PROD005,Shenzhen,10,729,719
2024-08-08,PROD007,Beijing,2,440,438
2024-08-09,PROD004,Shenzhen,3,516,513
2024-08-10,PROD005,Jilin,1,892,891
2024-08-11,PROD009,Jilin,3,570,567
2024-08-12,PROD012,Jilin,9,967,958
2024-08-13,PROD006,Beijing,9,987,978
2024-08-14,PROD003,Shanghai,4,1194,1190
2024-08-15,PROD006,Beijing,8,978,970
2024-08-16,PROD013,Guangzhou,9,807,798
2024-08-17,PROD009,Beijing,1,620,619
2024-08-18,PROD004,Shanghai,6,1317,1311
2024-08-19,PROD007,Shenzhen,9,723,714
2024-08-20,PROD008,Beijing,2,579,577
2024-08-21,PROD018,Shanghai,1,1025,1024
2024-08-22,PROD016,Beijing,4,1258,1254
2024-08-23,PROD001,Shenzhen,1,718,717
2024-08-24,PROD018,Beijing,3,1035,1032
2024-08-25,PROD002,Jilin,9,1015,1006
2024-08-26,PROD020,Beijing,6,1155,1149
2024-08-27,PROD004,Jilin,4,504,500
2024-08-28,PROD004,Shanghai,6,1311,1305
2024-08-29,PROD003,Shenzhen,10,1136,1126
2024-08-30,PROD003,Guangzhou,5,1124,1119
2024-08-31,PROD008,Beijing,2,577,575
2024-09-01,PROD014,Guangzhou,5,481,476
2024-09-02,PROD017,Shenzhen,4,950,946
2024-09-03,PROD002,Jilin,8,1006,998
2024-09-04,PROD015,Beijing,5,1021,1016
2024-09-05,PROD011,Beijing,1,1447,1446
2024-09-06,PROD012,Jilin,4,958,954
2024-09-07,PROD017,Shenzhen,8,946,938
2024-09-08,PROD001,Beijing,1,489,488
2024-09-09,PROD016,Beijing,6,1254,1248
2024-09-10,PROD007,Shenzhen,2,714,712
2024-09-11,PROD001,Guangzhou,7,1204,1197
2024-09-12,PROD006,Shanghai,4,522,518
2024-09-13,PROD010,Jilin,4,590,586
2024-09-14,PROD007,Jilin,8,484,476
2024-09-15,PROD015,Jilin,8,1103,1095
2024-09-16,PROD006,Jilin,7,977,970
2024-09-17,PROD015,Shenzhen,5,910,905
2024-09-18,PROD002,Shenzhen,7,1304,1297
2024-09-19,PROD003,Guangzhou,9,1119,1110
2024-09-20,PROD002,Shenzhen,5,1297,1292
2024-09-21,PROD020,Jilin,7,1285,1278
2024-09-22,PROD006,Jilin,2,970,968
2024-09-23,PROD011,Guangzhou,2,898,896
2024-09-24,PROD011,Jilin,8,606,598
2024-09-25,PROD015,Shenzhen,6,905,899
2024-09-26,PROD019,Guangzhou,3,1263,1260
2024-09-27,PROD006,Shanghai,5,518,513
2024-09-28,PROD006,Guangzhou,7,1339,1332
2024-09-29,PROD001,Shanghai,4,1100,1096
2024-09-30,PROD001,Shenzhen,7,717,710
2024-10-01,PROD004,Shenzhen,3,513,510
2024-10-02,PROD017,Guangzhou,1,541,540
2024-10-03,PROD001,Guangzhou,3,1197,1194
2024-10-04,PROD009,Shenzhen,10,682,672
2024-10-05,PROD003,Shenzhen,7,1126,1119
2024-10-06,PROD013,Jilin,3,953,950
2024-10-07,PROD009,Shenzhen,6,672,666
2024-10-08,PROD009,Shanghai,2,651,649
2024-10-09,PROD020,Jilin,5,1278,1273
2024-10-10,PROD017,Shenzhen,6,938,932
2024-10-11,PROD007,Guangzhou,9,1059,1050
2024-10-12,PROD006,Jilin,2,968,966
2024-10-13,PROD004,Beijing,6,864,858
2024-10-14,PROD001,Shenzhen,4,710,706
2024-10-15,PROD006,Jilin,7,966,959
2024-10-16,PROD011,Shanghai,8,740,732
2024-10-17,PROD018,Shenzhen,7,1156,1149
2024-10-18,PROD015,Beijing,5,1016,1011
2024-10-19,PROD001,Shenzhen,2,706,704
2024-10-20,PROD019,Shenzhen,7,873,866
2024-10-21,PROD010,Guangzhou,10,1403,1393
2024-10-22,PROD002,Guangzhou,8,1102,1094
2024-10-23,PROD006,Beijing,2,970,968
2024-10-24,PROD016,Shanghai,9,1289,1280
2024-10-25,PROD001,Shanghai,7,1096,1089
2024-10-26,PROD009,Beijing,10,619,609
2024-10-27,PROD002,Jilin,6,998,992
2024-10-28,PROD017,Shanghai,6,866,860
2024-10-29,PROD014,Guangzhou,2,476,474
2024-10-30,PROD006,Guangzhou,10,1332,1322
2024-10-31,PROD003,Beijing,1,1382,1381
2024-11-01,PROD012,Guangzhou,2,544,542
2024-11-02,PROD004,Beijing,9,858,849
2024-11-03,PROD019,Beijing,1,732,731
2024-11-04,PROD017,Shanghai,3,860,857
2024-11-05,PROD008,Beijing,5,575,570
2024-11-06,PROD007,Shenzhen,10,712,702
2024-11-07,PROD018,Guangzhou,9,1117,1108
2024-11-08,PROD005,Jilin,10,891,881
2024-11-09,PROD019,Shenzhen,2,866,864
2024-11-10,PROD015,Beijing,6,1011,1005
2024-11-11,PROD016,Guangzhou,4,475,471
2024-11-12,PROD009,Beijing,9,609,600
2024-11-13,PROD009,Beijing,10,600,590
2024-11-14,PROD020,Jilin,2,1273,1271
2024-11-15,PROD003,Shanghai,10,1190,1180
2024-11-16,PROD016,Shanghai,2,1280,1278
2024-11-17,PROD020,Shenzhen,7,1211,1204
2024-11-18,PROD012,Beijing,4,1203,1199
2024-11-19,PROD018,Jilin,1,1441,1440
2024-11-20,PROD015,Jilin,9,1095,1086
2024-11-21,PROD018,Shenzhen,3,1149,1146
2024-11-22,PROD019,Shenzhen,7,864,857
2024-11-23,PROD017,Jilin,2,1207,1205
2024-11-24,PROD015,Shanghai,3,488,485
2024-11-25,PROD011,Jilin,8,598,590
2024-11-26,PROD003,Beijing,7,1381,1374
2024-11-27,PROD018,Beijing,7,1032,1025
2024-11-28,PROD019,Jilin,6,994,988
2024-11-29,PROD011,Beijing,1,1446,1445
2024-11-30,PROD008,Beijing,6,570,564
2024-12-01,PROD018,Beijing,5,1025,1020
2024-12-02,PROD008,Shanghai,9,544,535
2024-12-03,PROD006,Shenzhen,2,544,542
2024-12-04,PROD016,Shenzhen,8,495,487
2024-12-05,PROD011,Guangzhou,1,896,895
2024-12-06,PROD008,Jilin,2,661,659
2024-12-07,PROD016,Shanghai,4,1278,1274
2024-12-08,PROD009,Beijing,3,590,587
2024-12-09,PROD020,Jilin,1,1271,1270
2024-12-10,PROD013,Shanghai,4,1076,1072
2024-12-11,PROD014,Shanghai,8,740,732
2024-12-12,PROD018,Jilin,6,1440,1434
2024-12-13,PROD002,Shenzhen,9,1292,1283
2024-12-14,PROD007,Shenzhen,10,702,692
2024-12-15,PROD019,Shenzhen,8,857,849
2024-12-16,PROD010,Guangzhou,2,1393,1391
2024-12-17,PROD012,Shenzhen,9,403,394
2024-12-18,PROD015,Beijing,6,1005,999
2024-12-19,PROD014,Guangzhou,1,474,473
2024-12-20,PROD001,Guangzhou,6,1194,1188
2024-12-21,PROD020,Shanghai,10,560,550
2024-12-22,PROD008,Beijing,6,564,558
2024-12-23,PROD015,Beijing,1,999,998
2024-12-24,PROD019,Shanghai,8,1154,1146
2024-12-25,PROD014,Guangzhou,7,473,466
2024-12-26,PROD008,Beijing,3,558,555
2024-12-27,PROD001,Beijing,8,488,480
2024-12-28,PROD001,Beijing,3,480,477
2024-12-29,PROD001,Shanghai,9,1089,1080
2024-12-30,PROD005,Jilin,8,881,873
2024-01-01,PROD020,Shenzhen,5,1204,1199
2024-01-02,PROD004,Jilin,10,500,490
2024-01-03,PROD019,Jilin,1,988,987
2024-01-04,PROD012,Shenzhen,2,394,392
2024-01-05,PROD011,Jilin,2,590,588
2024-01-06,PROD005,Jilin,3,873,870
2024-01-07,PROD001,Jilin,8,587,579
2024-01-08,PROD004,Shanghai,2,1305,1303
2024-01-09,PROD004,Shenzhen,3,510,507
2024-01-10,PROD007,Shanghai,6,664,658
2024-01-11,PROD016,Shenzhen,9,487,478
2024-01-12,PROD013,Jilin,2,950,948
2024-01-13,PROD014,Jilin,9,798,789
2024-01-14,PROD018,Shanghai,5,1024,1019
2024-01-15,PROD018,Jilin,1,1434,1433
2024-01-16,PROD002,Jilin,3,992,989
2024-01-17,PROD011,Beijing,4,1445,1441
2024-01-18,PROD019,Shenzhen,7,849,842
2024-01-19,PROD011,Shanghai,2,732,730
2024-01-20,PROD004,Beijing,5,849,844
2024-01-21,PROD011,Shenzhen,4,1020,1016
2024-01-22,PROD008,Shenzhen,4,808,804
2024-01-23,PROD006,Beijing,8,968,960
2024-01-24,PROD002,Beijing,9,1010,1001
2024-01-25,PROD011,Jilin,7,588,581
2024-01-26,PROD002,Guangzhou,6,1094,1088
2024-01-27,PROD014,Jilin,2,789,787
2024-01-28,PROD006,Shenzhen,10,542,532
2024-01-29,PROD007,Shanghai,10,658,648
2024-01-30,PROD018,Guangzhou,3,1108,1105
2024-01-31,PROD016,Jilin,2,793,791
2024-02-01,PROD008,Jilin,3,659,656
2024-02-02,PROD014,Shanghai,7,732,725
2024-02-03,PROD017,Guangzhou,6,540,534
2024-02-04,PROD019,Guangzhou,2,1260,1258
2024-02-05,PROD016,Guangzhou,2,471,469
2024-02-06,PROD013,Shanghai,10,1072,1062
2024-02-07,PROD004,Guangzhou,1,1367,1366
2024-02-08,PROD009,Shanghai,6,649,643
2024-02-09,PROD018,Jilin,3,1433,1430
2024-02-10,PROD005,Shanghai,2,893,891
2024-02-11,PROD003,Guangzhou,4,1110,1106
2024-02-12,PROD007,Guangzhou,9,1050,1041
2024-02-13,PROD014,Shanghai,2,725,723
2024-02-14,PROD005,Shanghai,4,891,887
2024-02-15,PROD009,Shanghai,10,643,633
2024-02-16,PROD003,Jilin,6,1280,1274
2024-02-17,PROD005,Shanghai,4,887,883
2024-02-18,PROD013,Beijing,3,1149,1146
2024-02-19,PROD016,Shanghai,6,1274,1268
2024-02-20,PROD001,Jilin,7,579,572
2024-02-21,PROD009,Jilin,10,567,557
2024-02-22,PROD011,Shanghai,9,730,721
2024-02-23,PROD002,Guangzhou,9,1088,1079
2024-02-24,PROD010,Guangzhou,5,1391,1386
2024-02-25,PROD006,Shenzhen,7,532,525
2024-02-26,PROD011,Jilin,2,581,579
2024-02-27,PROD009,Guangzhou,7,1260,1253
2024-02-28,PROD005,Shenzhen,6,719,713
2024-02-29,PROD010,Shanghai,10,736,726
2024-03-01,PROD003,Jilin,3,1274,1271
2024-03-02,PROD004,Beijing,10,844,834
2024-03-03,PROD015,Guangzhou,9,859,850
2024-03-04,PROD003,Jilin,1,1271,1270
2024-03-05,PROD014,Shanghai,10,723,713
2024-03-06,PROD013,Guangzhou,7,798,791
2024-03-07,PROD005,Jilin,9,870,861
2024-03-08,PROD010,Shenzhen,9,1004,995
2024-03-09,PROD003,Guangzhou,2,1106,1104
2024-03-10,PROD002,Jilin,5,989,984
2024-03-11,PROD017,Jilin,6,1205,1199
2024-03-12,PROD007,Jilin,8,476,468
2024-03-13,PROD009,Guangzhou,6,1253,1247
2024-03-14,PROD009,Guangzhou,2,1247,1245
2024-03-15,PROD008,Beijing,1,555,554
2024-03-16,PROD012,Jilin,5,954,949
2024-03-17,PROD011,Shenzhen,10,1016,1006
2024-03-18,PROD007,Beijing,3,438,435
2024-03-19,PROD001,Beijing,1,477,476
2024-03-20,PROD012,Jilin,8,949,941
2024-03-21,PROD006,Jilin,10,959,949
2024-03-22,PROD019,Shanghai,8,1146,1138
2024-03-23,PROD014,Guangzhou,5,466,461
2024-03-24,PROD017,Guangzhou,9,534,525
2024-03-25,PROD017,Beijing,4,1251,1247
2024-03-26,PROD001,Shanghai,7,1080,1073
2024-03-27,PROD012,Beijing,10,1199,1189
2024-03-28,PROD018,Jilin,2,1430,1428
2024-03-29,PROD003,Shenzhen,5,1119,1114
2024-03-30,PROD007,Beijing,10,435,425
2024-03-31,PROD002,Shenzhen,5,1283,1278
2024-04-01,PROD018,Shanghai,8,1019,1011
2024-04-02,PROD006,Jilin,9,949,940
2024-04-03,PROD006,Guangzhou,3,1322,1319
2024-04-04,PROD017,Guangzhou,1,525,524
2024-04-05,PROD014,Shenzhen,8,769,761
2024-04-06,PROD010,Shanghai,2,726,724
2024-04-07,PROD018,Guangzhou,5,1105,1100
2024-04-08,PROD013,Jilin,10,948,938
2024-04-09,PROD010,Shenzhen,9,995,986
2024-04-10,PROD020,Shanghai,1,550,549
2024-04-11,PROD015,Jilin,1,1086,1085
2024-04-12,PROD008,Shanghai,1,535,534
2024-04-13,PROD018,Shanghai,5,1011,1006
2024-04-14,PROD015,Beijing,9,998,989
2024-04-15,PROD006,Shenzhen,4,525,521
2024-04-16,PROD016,Shanghai,1,1268,1267
2024-04-17,PROD011,Jilin,4,579,575
2024-04-18,PROD004,Beijing,8,834,826
2024-04-19,PROD014,Guangzhou,8,461,453
2024-04-20,PROD010,Jilin,4,586,582
2024-04-21,PROD012,Beijing,2,1189,1187
2024-04-22,PROD001,Beijing,4,476,472
2024-04-23,PROD006,Shanghai,6,513,507
2024-04-24,PROD020,Guangzhou,1,629,628
2024-04-25,PROD020,Beijing,7,1149,1142
2024-04-26,PROD009,Jilin,4,557,553
2024-04-27,PROD018,Beijing,7,1020,1013
2024-04-28,PROD001,Jilin,6,572,566
2024-04-29,PROD014,Guangzhou,10,453,443
2024-04-30,PROD019,Shanghai,3,1138,1135
2024-05-01,PROD019,Guangzhou,9,1258,1249
2024-05-02,PROD011,Beijing,5,1441,1436
2024-05-03,PROD007,Guangzhou,10,1041,1031
2024-05-04,PROD010,Jilin,6,582,576
2024-05-05,PROD012,Jilin,1,941,940
2024-05-06,PROD016,Jilin,2,791,789
2024-05-07,PROD019,Jilin,3,987,984
2024-05-08,PROD005,Jilin,2,861,859
2024-05-09,PROD012,Jilin,2,940,938
2024-05-10,PROD018,Jilin,4,1428,1424
2024-05-11,PROD010,Jilin,8,576,568
2024-05-12,PROD004,Guangzhou,8,1366,1358
2024-05-13,PROD001,Jilin,1,566,565
2024-05-14,PROD005,Shanghai,5,883,878
2024-05-15,PROD004,Beijing,1,826,825
2024-05-16,PROD015,Jilin,1,1085,1084
2024-05-17,PROD020,Shanghai,9,549,540
2024-05-18,PROD020,Shenzhen,4,1199,1195
2024-05-19,PROD010,Beijing,1,1376,1375
2024-05-20,PROD009,Jilin,7,553,546
2024-05-21,PROD007,Jilin,3,468,465
2024-05-22,PROD019,Jilin,3,984,981
2024-05-23,PROD011,Guangzhou,8,895,887
2024-05-24,PROD012,Guangzhou,8,542,534
2024-05-25,PROD004,Jilin,1,490,489
2024-05-26,PROD019,Guangzhou,8,1249,1241
2024-05-27,PROD007,Beijing,2,425,423
2024-05-28,PROD009,Jilin,8,546,538
2024-05-29,PROD014,Jilin,2,787,785
2024-05-30,PROD011,Shenzhen,1,1006,1005
2024-05-31,PROD011,Shanghai,4,721,717
2024-06-01,PROD002,Shenzhen,7,1278,1271
2024-06-02,PROD003,Jilin,9,1270,1261
2024-06-03,PROD007,Shanghai,1,648,647
2024-06-04,PROD005,Shanghai,9,878,869
2024-06-05,PROD002,Shenzhen,2,1271,1269
2024-06-06,PROD016,Shanghai,8,1267,1259
2024-06-07,PROD011,Jilin,6,575,569
2024-06-08,PROD009,Jilin,1,538,537
2024-06-09,PROD019,Shanghai,4,1135,1131
2024-06-10,PROD010,Jilin,7,568,561
2024-06-11,PROD007,Guangzhou,6,1031,1025
2024-06-12,PROD007,Guangzhou,4,1025,1021
2024-06-13,PROD012,Guangzhou,5,534,529
2024-06-14,PROD013,Guangzhou,2,791,789
2024-06-15,PROD012,Guangzhou,5,529,524
2024-06-16,PROD010,Guangzhou,9,1386,1377
2024-06-17,PROD005,Shenzhen,9,713,704
2024-06-18,PROD004,Beijing,7,825,818
2024-06-19,PROD001,Beijing,7,472,465
2024-06-20,PROD004,Guangzhou,9,1358,1349
2024-06-21,PROD014,Guangzhou,5,443,438
2024-06-22,PROD006,Jilin,10,940,930
2024-06-23,PROD016,Shanghai,2,1259,1257
2024-06-24,PROD005,Jilin,4,859,855
2024-06-25,PROD010,Guangzhou,1,1377,1376
2024-06-26,PROD016,Shenzhen,6,478,472
2024-06-27,PROD008,Shanghai,5,534,529
2024-06-28,PROD017,Guangzhou,9,524,515
2024-06-29,PROD005,Guangzhou,1,585,584
2024-06-30,PROD002,Shanghai,6,618,612
2024-07-01,PROD011,Shanghai,4,717,713
2024-07-02,PROD007,Shanghai,9,647,638
2024-07-03,PROD020,Shenzhen,8,1195,1187
2024-07-04,PROD004,Beijing,9,818,809
2024-07-05,PROD020,Jilin,1,1270,1269
2024-07-06,PROD002,Jilin,1,984,983
2024-07-07,PROD001,Shanghai,5,1073,1068
2024-07-08,PROD016,Jilin,3,789,786
2024-07-09,PROD014,Shanghai,10,713,703
2024-07-10,PROD009,Jilin,1,537,536
2024-07-11,PROD012,Beijing,9,1187,1178
2024-07-12,PROD014,Jilin,9,785,776
2024-07-13,PROD003,Guangzhou,9,1104,1095
2024-07-14,PROD013,Guangzhou,4,789,785
2024-07-15,PROD018,Shenzhen,3,1146,1143
2024-07-16,PROD019,Shenzhen,2,842,840
2024-07-17,PROD016,Shanghai,3,1257,1254
2024-07-18,PROD018,Guangzhou,1,1100,1099
2024-07-19,PROD011,Guangzhou,9,887,878
2024-07-20,PROD002,Shenzhen,9,1269,1260
2024-07-21,PROD017,Shenzhen,9,932,923
2024-07-22,PROD017,Beijing,6,1247,1241
2024-07-23,PROD001,Shenzhen,9,704,695
2024-07-24,PROD019,Guangzhou,10,1241,1231
2024-07-25,PROD018,Shenzhen,10,1143,1133
2024-07-26,PROD019,Jilin,6,981,975
2024-07-27,PROD005,Shenzhen,6,704,698
2024-07-28,PROD018,Guangzhou,7,1099,1092
2024-07-29,PROD007,Jilin,8,465,457
2024-07-30,PROD018,Shanghai,9,1006,997
2024-07-31,PROD011,Shenzhen,10,1005,995
2024-08-01,PROD006,Beijing,1,960,959
2024-08-02,PROD010,Shenzhen,5,986,981
2024-08-03,PROD019,Guangzhou,6,1231,1225
2024-08-04,PROD001,Jilin,10,565,555
2024-08-05,PROD001,Jilin,1,555,554
2024-08-06,PROD017,Beijing,4,1241,1237
2024-08-07,PROD006,Shenzhen,4,521,517
2024-08-08,PROD010,Beijing,9,1375,1366
2024-08-09,PROD020,Shenzhen,5,1187,1182
2024-08-10,PROD010,Beijing,8,1366,1358
2024-08-11,PROD018,Jilin,6,1424,1418
2024-08-12,PROD010,Jilin,8,561,553
2024-08-13,PROD009,Jilin,2,536,534
2024-08-14,PROD005,Beijing,9,780,771
2024-08-15,PROD001,Jilin,5,554,549
2024-08-16,PROD020,Beijing,5,1142,1137
2024-08-17,PROD006,Guangzhou,7,1319,1312
2024-08-18,PROD020,Guangzhou,7,628,621
2024-08-19,PROD006,Shenzhen,6,517,511
2024-08-20,PROD014,Shenzhen,7,761,754
2024-08-21,PROD002,Beijing,5,1001,996
2024-08-22,PROD015,Beijing,7,989,982
2024-08-23,PROD011,Guangzhou,4,878,874
2024-08-24,PROD005,Guangzhou,7,584,577
2024-08-25,PROD018,Shanghai,8,997,989
2024-08-26,PROD011,Shenzhen,10,995,985
2024-08-27,PROD001,Beijing,4,465,461
2024-08-28,PROD002,Shanghai,10,612,602
2024-08-29,PROD015,Beijing,8,982,974
2024-08-30,PROD018,Shanghai,2,989,987
2024-08-31,PROD019,Beijing,8,731,723
2024-09-01,PROD016,Beijing,3,1248,1245
2024-09-02,PROD003,Guangzhou,6,1095,1089
2024-09-03,PROD003,Beijing,1,1374,1373
2024-09-04,PROD014,Shenzhen,9,754,745
2024-09-05,PROD019,Shenzhen,8,840,832
2024-09-06,PROD011,Shenzhen,1,985,984
2024-09-07,PROD003,Shenzhen,10,1114,1104
2024-09-08,PROD016,Beijing,2,1245,1243
2024-09-09,PROD007,Jilin,10,457,447
2024-09-10,PROD002,Shanghai,9,602,593
2024-09-11,PROD020,Beijing,10,1137,1127
2024-09-12,PROD002,Shanghai,10,593,583
2024-09-13,PROD014,Jilin,1,776,775
2024-09-14,PROD014,Guangzhou,9,438,429
2024-09-15,PROD010,Shenzhen,5,981,976
2024-09-16,PROD005,Jilin,1,855,854
2024-09-17,PROD011,Shenzhen,1,984,983
2024-09-18,PROD016,Guangzhou,7,469,462
2024-09-19,PROD020,Shenzhen,5,1182,1177
2024-09-20,PROD011,Beijing,3,1436,1433
2024-09-21,PROD016,Shenzhen,7,472,465
2024-09-22,PROD009,Shanghai,5,633,628
2024-09-23,PROD005,Guangzhou,4,577,573
2024-09-24,PROD019,Shanghai,1,1131,1130
2024-09-25,PROD007,Guangzhou,9,1021,1012
2024-09-26,PROD003,Shanghai,10,1180,1170
2024-09-27,PROD013,Shenzhen,1,1295,1294
2024-09-28,PROD004,Guangzhou,2,1349,1347
2024-09-29,PROD009,Beijing,9,587,578
2024-09-30,PROD012,Shanghai,4,891,887
2024-10-01,PROD010,Shanghai,8,724,716
2024-10-02,PROD020,Shenzhen,9,1177,1168
2024-10-03,PROD004,Beijing,1,809,808
2024-10-04,PROD018,Shenzhen,7,1133,1126
2024-10-05,PROD014,Beijing,3,606,603
2024-10-06,PROD008,Jilin,8,656,648
2024-10-07,PROD001,Shanghai,1,1068,1067
2024-10-08,PROD004,Beijing,10,808,798
2024-10-09,PROD006,Guangzhou,4,1312,1308
2024-10-10,PROD014,Shenzhen,9,745,736
2024-10-11,PROD003,Shenzhen,5,1104,1099
2024-10-12,PROD003,Shenzhen,1,1099,1098
2024-10-13,PROD005,Guangzhou,6,573,567
2024-10-14,PROD004,Jilin,4,489,485
2024-10-15,PROD018,Guangzhou,5,1092,1087
2024-10-16,PROD020,Guangzhou,5,621,616
2024-10-17,PROD003,Shanghai,1,1170,1169
2024-10-18,PROD015,Guangzhou,2,850,848
2024-10-19,PROD006,Shenzhen,8,511,503
2024-10-20,PROD014,Beijing,3,603,600
2024-10-21,PROD011,Shanghai,9,713,704
2024-10-22,PROD006,Jilin,6,930,924
2024-10-23,PROD007,Shenzhen,4,692,688
2024-10-24,PROD001,Shanghai,9,1067,1058
2024-10-25,PROD020,Guangzhou,10,616,606
2024-10-26,PROD020,Shanghai,10,540,530
2024-10-27,PROD001,Guangzhou,9,1188,1179
2024-10-28,PROD010,Shanghai,8,716,708
2024-10-29,PROD005,Jilin,7,854,847
2024-10-30,PROD015,Guangzhou,6,848,842
2024-10-31,PROD014,Shenzhen,7,736,729
2024-11-01,PROD018,Jilin,7,1418,1411
2024-11-02,PROD016,Guangzhou,9,462,453
2024-11-03,PROD002,Beijing,4,996,992
2024-11-04,PROD020,Jilin,10,1269,1259
2024-11-05,PROD008,Beijing,8,554,546
2024-11-06,PROD018,Jilin,3,1411,1408
2024-11-07,PROD008,Beijing,8,546,538
2024-11-08,PROD005,Beijing,7,771,764
2024-11-09,PROD016,Shanghai,5,1254,1249
2024-11-10,PROD020,Beijing,2,1127,1125
2024-11-11,PROD001,Beijing,8,461,453
2024-11-12,PROD001,Shenzhen,10,695,685
2024-11-13,PROD017,Guangzhou,4,515,511
2024-11-14,PROD009,Shenzhen,9,666,657
2024-11-15,PROD007,Guangzhou,2,1012,1010
2024-11-16,PROD011,Guangzhou,1,874,873
2024-11-17,PROD020,Jilin,8,1259,1251
2024-11-18,PROD007,Shanghai,1,638,637
2024-11-19,PROD018,Shanghai,5,987,982
2024-11-20,PROD003,Shanghai,4,1169,1165
2024-11-21,PROD016,Shanghai,4,1249,1245
2024-11-22,PROD016,Jilin,9,786,777
2024-11-23,PROD010,Shanghai,1,708,707
2024-11-24,PROD003,Shenzhen,7,1098,1091
2024-11-25,PROD017,Shanghai,3,857,854
2024-11-26,PROD015,Guangzhou,9,842,833
2024-11-27,PROD019,Shenzhen,9,832,823
2024-11-28,PROD009,Jilin,4,534,530
2024-11-29,PROD019,Jilin,2,975,973
2024-11-30,PROD019,Shenzhen,3,823,820
2024-12-01,PROD004,Guangzhou,9,1347,1338
2024-12-02,PROD019,Shenzhen,6,820,814
2024-12-03,PROD019,Shenzhen,7,814,807
2024-12-04,PROD002,Shenzhen,7,1260,1253
2024-12-05,PROD007,Beijing,4,423,419
2024-12-06,PROD017,Jilin,3,1199,1196
2024-12-07,PROD018,Jilin,7,1408,1401
2024-12-08,PROD013,Shanghai,2,1062,1060
2024-12-09,PROD018,Beijing,8,1013,1005
2024-12-10,PROD018,Jilin,1,1401,1400
2024-12-11,PROD008,Beijing,2,538,536
2024-12-12,PROD013,Beijing,3,1146,1143
2024-12-13,PROD010,Guangzhou,1,1376,1375
2024-12-14,PROD011,Shenzhen,8,983,975
2024-12-15,PROD019,Shanghai,6,1130,1124
2024-12-16,PROD015,Guangzhou,5,833,828
2024-12-17,PROD009,Jilin,8,530,522
2024-12-18,PROD013,Shenzhen,9,1294,1285
2024-12-19,PROD011,Guangzhou,7,873,866
2024-12-20,PROD002,Shanghai,4,583,579
2024-12-21,PROD005,Jilin,5,847,842
2024-12-22,PROD016,Shanghai,3,1245,1242
2024-12-23,PROD009,Jilin,7,522,515
2024-12-24,PROD014,Beijing,3,600,597
2024-12-25,PROD011,Guangzhou,5,866,861
2024-12-26,PROD003,Shanghai,2,1165,1163
2024-12-27,PROD013,Guangzhou,5,785,780
2024-12-28,PROD002,Guangzhou,9,1079,1070
2024-12-29,PROD013,Shanghai,7,1060,1053
2024-12-30,PROD006,Guangzhou,4,1308,1304
2024-01-01,PROD006,Shenzhen,4,503,499
2024-01-02,PROD012,Guangzhou,2,524,522
2024-01-03,PROD013,Beijing,5,1143,1138
2024-01-04,PROD012,Shanghai,3,887,884
2024-01-05,PROD003,Guangzhou,3,1089,1086
2024-01-06,PROD017,Jilin,5,1196,1191
2024-01-07,PROD005,Shenzhen,2,698,696
2024-01-08,PROD007,Shenzhen,1,688,687
2024-01-09,PROD005,Guangzhou,9,567,558
2024-01-10,PROD002,Guangzhou,6,1070,1064
2024-01-11,PROD016,Shanghai,10,1242,1232
2024-01-12,PROD013,Jilin,6,938,932
2024-01-13,PROD010,Shanghai,4,707,703
2024-01-14,PROD011,Shanghai,1,704,703
2024-01-15,PROD019,Shanghai,4,1124,1120
2024-01-16,PROD018,Shenzhen,4,1126,1122
2024-01-17,PROD012,Guangzhou,4,522,518
2024-01-18,PROD020,Beijing,4,1125,1121
2024-01-19,PROD009,Beijing,5,578,573
2024-01-20,PROD012,Guangzhou,5,518,513
2024-01-21,PROD005,Guangzhou,7,558,551
2024-01-22,PROD020,Shanghai,2,530,528
2024-01-23,PROD015,Beijing,6,974,968
2024-01-24,PROD004,Shanghai,10,1303,1293
2024-01-25,PROD019,Jilin,7,973,966
2024-01-26,PROD004,Guangzhou,9,1338,1329
2024-01-27,PROD014,Guangzhou,4,429,425
2024-01-28,PROD009,Guangzhou,9,1245,1236
2024-01-29,PROD018,Beijing,2,1005,1003
2024-01-30,PROD008,Shenzhen,1,804,803
2024-01-31,PROD006,Jilin,10,924,914
2024-02-01,PROD003,Jilin,8,1261,1253
2024-02-02,PROD002,Jilin,1,983,982
2024-02-03,PROD003,Beijing,4,1373,1369
2024-02-04,PROD017,Shenzhen,3,923,920
2024-02-05,PROD012,Beijing,7,1178,1171
2024-02-06,PROD015,Shenzhen,5,899,894
2024-02-07,PROD013,Beijing,3,1138,1135
2024-02-08,PROD010,Guangzhou,5,1375,1370
2024-02-09,PROD008,Guangzhou,1,1371,1370
2024-02-10,PROD011,Jilin,8,569,561
2024-02-11,PROD011,Shenzhen,5,975,970
2024-02-12,PROD010,Guangzhou,8,1370,1362
2024-02-13,PROD009,Guangzhou,7,1236,1229
2024-02-14,PROD013,Jilin,9,932,923
2024-02-15,PROD010,Beijing,1,1358,1357
2024-02-16,PROD018,Beijing,10,1003,993
2024-02-17,PROD009,Shanghai,8,628,620
2024-02-18,PROD011,Jilin,1,561,560
2024-02-19,PROD010,Guangzhou,8,1362,1354
2024-02-20,PROD017,Jilin,2,1191,1189
2024-02-21,PROD019,Jilin,8,966,958
2024-02-22,PROD008,Shenzhen,6,803,797
2024-02-23,PROD005,Shanghai,6,869,863
2024-02-24,PROD007,Shenzhen,3,687,684
2024-02-25,PROD009,Guangzhou,8,1229,1221
2024-02-26,PROD020,Beijing,6,1121,1115
2024-02-27,PROD006,Shanghai,9,507,498
2024-02-28,PROD018,Shanghai,9,982,973
2024-02-29,PROD006,Jilin,5,914,909
2024-03-01,PROD004,Guangzhou,5,1329,1324
2024-03-02,PROD002,Shanghai,8,579,571
2024-03-03,PROD001,Guangzhou,3,1179,1176
2024-03-04,PROD019,Shanghai,3,1120,1117
2024-03-05,PROD007,Shanghai,4,637,633
2024-03-06,PROD003,Shenzhen,7,1091,1084
2024-03-07,PROD001,Shanghai,1,1058,1057
2024-03-08,PROD003,Jilin,3,1253,1250
2024-03-09,PROD010,Jilin,3,553,550
2024-03-10,PROD013,Shenzhen,9,1285,1276
2024-03-11,PROD019,Guangzhou,9,1225,1216
2024-03-12,PROD004,Shanghai,2,1293,1291
2024-03-13,PROD003,Beijing,4,1369,1365
2024-03-14,PROD006,Guangzhou,2,1304,1302
2024-03-15,PROD003,Shenzhen,2,1084,1082
2024-03-16,PROD006,Shanghai,9,498,489
2024-03-17,PROD001,Shanghai,2,1057,1055
2024-03-18,PROD015,Beijing,1,968,967
2024-03-19,PROD005,Guangzhou,3,551,548
2024-03-20,PROD005,Guangzhou,10,548,538
2024-03-21,PROD006,Guangzhou,2,1302,1300
2024-03-22,PROD009,Guangzhou,8,1221,1213
2024-03-23,PROD003,Guangzhou,7,1086,1079
2024-03-24,PROD012,Beijing,10,1171,1161
2024-03-25,PROD009,Jilin,7,515,508
2024-03-26,PROD015,Guangzhou,9,828,819
2024-03-27,PROD009,Jilin,8,508,500
2024-03-28,PROD020,Shanghai,1,528,527
2024-03-29,PROD006,Guangzhou,1,1300,1299
2024-03-30,PROD013,Beijing,1,1135,1134
2024-03-31,PROD018,Guangzhou,2,1087,1085
2024-04-01,PROD012,Shenzhen,3,392,389
2024-04-02,PROD010,Jilin,7,550,543
2024-04-03,PROD004,Beijing,1,798,797
2024-04-04,PROD009,Jilin,6,500,494
2024-04-05,PROD007,Shanghai,9,633,624
2024-04-06,PROD006,Guangzhou,10,1299,1289
2024-04-07,PROD003,Shenzhen,7,1082,1075
2024-04-08,PROD019,Jilin,7,958,951
2024-04-09,PROD006,Shenzhen,1,499,498
2024-04-10,PROD016,Shanghai,6,1232,1226
2024-04-11,PROD011,Guangzhou,1,861,860
2024-04-12,PROD018,Guangzhou,4,1085,1081
2024-04-13,PROD010,Shanghai,10,703,693
2024-04-14,PROD001,Guangzhou,8,1176,1168
2024-04-15,PROD010,Jilin,3,543,540
2024-04-16,PROD008,Beijing,7,536,529
2024-04-17,PROD015,Shanghai,6,485,479
2024-04-18,PROD017,Shanghai,8,854,846
2024-04-19,PROD013,Beijing,8,1134,1126
2024-04-20,PROD017,Jilin,9,1189,1180
2024-04-21,PROD009,Shenzhen,10,657,647
2024-04-22,PROD004,Shenzhen,1,507,506
2024-04-23,PROD008,Guangzhou,10,1370,1360
2024-04-24,PROD006,Beijing,5,959,954
2024-04-25,PROD017,Shenzhen,7,920,913
2024-04-26,PROD016,Guangzhou,3,453,450
2024-04-27,PROD018,Beijing,4,993,989
2024-04-28,PROD014,Shanghai,1,703,702
2024-04-29,PROD006,Shanghai,7,489,482
2024-04-30,PROD020,Beijing,10,1115,1105
2024-05-01,PROD007,Beijing,5,419,414
2024-05-02,PROD020,Jilin,9,1251,1242
2024-05-03,PROD001,Shenzhen,4,685,681
2024-05-04,PROD017,Beijing,1,1237,1236
2024-05-05,PROD002,Beijing,6,992,986
2024-05-06,PROD017,Jilin,4,1180,1176
2024-05-07,PROD006,Shanghai,4,482,478
2024-05-08,PROD019,Guangzhou,1,1216,1215
2024-05-09,PROD019,Jilin,6,951,945
2024-05-10,PROD015,Beijing,1,967,966
2024-05-11,PROD020,Shanghai,10,527,517
2024-05-12,PROD010,Shenzhen,6,976,970
2024-05-13,PROD005,Beijing,7,764,757
2024-05-14,PROD007,Guangzhou,4,1010,1006
2024-05-15,PROD020,Shenzhen,7,1168,1161
2024-05-16,PROD002,Guangzhou,5,1064,1059
2024-05-17,PROD015,Jilin,7,1084,1077
2024-05-18,PROD010,Beijing,1,1357,1356
2024-05-19,PROD005,Shenzhen,4,696,692
2024-05-20,PROD020,Guangzhou,4,606,602
2024-05-21,PROD001,Shanghai,2,1055,1053
2024-05-22,PROD003,Shenzhen,9,1075,1066
2024-05-23,PROD011,Beijing,3,1433,1430
2024-05-24,PROD006,Jilin,10,909,899
2024-05-25,PROD013,Guangzhou,6,780,774
2024-05-26,PROD019,Shanghai,2,1117,1115
2024-05-27,PROD002,Beijing,5,986,981
2024-05-28,PROD008,Beijing,7,529,522
2024-05-29,PROD002,Beijing,3,981,978
2024-05-30,PROD014,Shanghai,9,702,693
2024-05-31,PROD020,Shanghai,4,517,513
2024-06-01,PROD012,Shenzhen,6,389,383
2024-06-02,PROD008,Guangzhou,8,1360,1352
2024-06-03,PROD010,Beijing,2,1356,1354
2024-06-04,PROD012,Shenzhen,2,383,381
2024-06-05,PROD013,Guangzhou,10,774,764
2024-06-06,PROD006,Shenzhen,10,498,488
2024-06-07,PROD005,Jilin,6,842,836
2024-06-08,PROD016,Shenzhen,9,465,456
2024-06-09,PROD019,Shanghai,5,1115,1110
2024-06-10,PROD006,Guangzhou,6,1289,1283
2024-06-11,PROD012,Jilin,1,938,937
2024-06-12,PROD013,Shenzhen,9,1276,1267
2024-06-13,PROD010,Jilin,2,540,538
2024-06-14,PROD012,Shanghai,1,884,883
2024-06-15,PROD001,Jilin,8,549,541
2024-06-16,PROD004,Jilin,7,485,478
2024-06-17,PROD002,Guangzhou,3,1059,1056
2024-06-18,PROD004,Jilin,2,478,476
2024-06-19,PROD008,Beijing,9,522,513
2024-06-20,PROD004,Guangzhou,5,1324,1319
2024-06-21,PROD011,Shenzhen,6,970,964
2024-06-22,PROD012,Beijing,10,1161,1151
2024-06-23,PROD004,Beijing,3,797,794
2024-06-24,PROD003,Guangzhou,10,1079,1069
2024-06-25,PROD007,Guangzhou,1,1006,1005
2024-06-26,PROD014,Jilin,7,775,768
2024-06-27,PROD015,Beijing,7,966,959
2024-06-28,PROD007,Jilin,3,447,444
2024-06-29,PROD014,Jilin,1,768,767
2024-06-30,PROD019,Beijing,9,723,714
2024-07-01,PROD004,Guangzhou,3,1319,1316
2024-07-02,PROD020,Shanghai,9,513,504
2024-07-03,PROD016,Beijing,6,1243,1237
2024-07-04,PROD017,Shanghai,3,846,843
2024-07-05,PROD010,Shenzhen,6,970,964
2024-07-06,PROD016,Shanghai,8,1226,1218
2024-07-07,PROD015,Guangzhou,8,819,811
2024-07-08,PROD016,Shanghai,10,1218,1208
2024-07-09,PROD005,Shenzhen,2,692,690
2024-07-10,PROD004,Beijing,7,794,787
2024-07-11,PROD010,Guangzhou,7,1354,1347
2024-07-12,PROD005,Shanghai,7,863,856
2024-07-13,PROD012,Guangzhou,1,513,512
2024-07-14,PROD011,Jilin,3,560,557
2024-07-15,PROD014,Shanghai,3,693,690
2024-07-16,PROD005,Shenzhen,7,690,683
2024-07-17,PROD020,Shenzhen,4,1161,1157
2024-07-18,PROD001,Beijing,8,453,445
2024-07-19,PROD009,Shanghai,4,620,616
2024-07-20,PROD019,Shenzhen,4,807,803
2024-07-21,PROD008,Shenzhen,7,797,790
2024-07-22,PROD005,Guangzhou,3,538,535
2024-07-23,PROD018,Guangzhou,7,1081,1074
2024-07-24,PROD008,Beijing,7,513,506
2024-07-25,PROD009,Shanghai,2,616,614
2024-07-26,PROD016,Shanghai,10,1208,1198
2024-07-27,PROD017,Guangzhou,9,511,502
2024-07-28,PROD020,Shenzhen,5,1157,1152
2024-07-29,PROD010,Jilin,10,538,528
2024-07-30,PROD007,Beijing,3,414,411
2024-07-31,PROD009,Shenzhen,9,647,638
2024-08-01,PROD015,Beijing,9,959,950
2024-08-02,PROD015,Jilin,2,1077,1075
2024-08-03,PROD017,Guangzhou,1,502,501
2024-08-04,PROD006,Guangzhou,4,1283,1279
2024-08-05,PROD010,Guangzhou,8,1347,1339
2024-08-06,PROD019,Jilin,5,945,940
2024-08-07,PROD015,Shanghai,2,479,477
2024-08-08,PROD012,Guangzhou,1,512,511
2024-08-09,PROD013,Beijing,5,1126,1121
2024-08-10,PROD016,Beijing,9,1237,1228
2024-08-11,PROD010,Jilin,4,528,524
2024-08-12,PROD008,Beijing,6,506,500
2024-08-13,PROD010,Jilin,6,524,518
2024-08-14,PROD010,Shenzhen,4,964,960
2024-08-15,PROD006,Shenzhen,3,488,485
2024-08-16,PROD018,Beijing,6,989,983
2024-08-17,PROD019,Beijing,10,714,704
2024-08-18,PROD015,Beijing,9,950,941
2024-08-19,PROD013,Beijing,3,1121,1118
2024-08-20,PROD011,Jilin,4,557,553
2024-08-21,PROD016,Shanghai,5,1198,1193
2024-08-22,PROD003,Beijing,7,1365,1358
2024-08-23,PROD005,Jilin,6,836,830
2024-08-24,PROD018,Jilin,3,1400,1397
2024-08-25,PROD013,Beijing,9,1118,1109
2024-08-26,PROD005,Shenzhen,4,683,679
2024-08-27,PROD008,Beijing,3,500,497
2024-08-28,PROD011,Shenzhen,7,964,957
2024-08-29,PROD016,Beijing,2,1228,1226
2024-08-30,PROD007,Beijing,3,411,408
2024-08-31,PROD016,Shenzhen,7,456,449
2024-09-01,PROD012,Jilin,9,937,928
2024-09-02,PROD002,Jilin,6,982,976
2024-09-03,PROD017,Shanghai,1,843,842
2024-09-04,PROD010,Guangzhou,5,1339,1334
2024-09-05,PROD011,Shanghai,9,703,694
2024-09-06,PROD016,Guangzhou,5,450,445
2024-09-07,PROD001,Beijing,10,445,435
2024-09-08,PROD014,Shenzhen,8,729,721
2024-09-09,PROD002,Jilin,7,976,969
2024-09-10,PROD017,Beijing,8,1236,1228
2024-09-11,PROD019,Shenzhen,2,803,801
2024-09-12,PROD018,Beijing,7,983,976
2024-09-13,PROD001,Jilin,6,541,535
2024-09-14,PROD002,Beijing,6,978,972
2024-09-15,PROD002,Jilin,3,969,966
2024-09-16,PROD002,Beijing,8,972,964
2024-09-17,PROD004,Shenzhen,4,506,502
2024-09-18,PROD015,Beijing,10,941,931
2024-09-19,PROD002,Guangzhou,2,1056,1054
2024-09-20,PROD019,Shenzhen,7,801,794
2024-09-21,PROD020,Shanghai,4,504,500
2024-09-22,PROD011,Guangzhou,10,860,850
2024-09-23,PROD001,Beijing,10,435,425
2024-09-24,PROD007,Shenzhen,10,684,674
2024-09-25,PROD010,Beijing,8,1354,1346
2024-09-26,PROD009,Jilin,7,494,487
2024-09-27,PROD011,Jilin,10,553,543
2024-09-28,PROD008,Shenzhen,5,790,785
2024-09-29,PROD009,Jilin,7,487,480
2024-09-30,PROD010,Jilin,8,518,510
2024-10-01,PROD016,Beijing,9,1226,1217
2024-10-02,PROD012,Shanghai,6,883,877
2024-10-03,PROD020,Shenzhen,2,1152,1150
2024-10-04,PROD006,Beijing,10,954,944
2024-10-05,PROD001,Beijing,3,425,422
2024-10-06,PROD002,Shenzhen,9,1253,1244
2024-10-07,PROD016,Beijing,1,1217,1216
2024-10-08,PROD014,Shenzhen,1,721,720
2024-10-09,PROD020,Jilin,5,1242,1237
2024-10-10,PROD005,Shenzhen,7,679,672
2024-10-11,PROD006,Shanghai,1,478,477
2024-10-12,PROD007,Shenzhen,10,674,664
2024-10-13,PROD017,Shenzhen,3,913,910
2024-10-14,PROD003,Shanghai,8,1163,1155
2024-10-15,PROD006,Shenzhen,1,485,484
2024-10-16,PROD001,Shenzhen,5,681,676
2024-10-17,PROD007,Shanghai,8,624,616
2024-10-18,PROD019,Jilin,4,940,936
2024-10-19,PROD001,Beijing,4,422,418
2024-10-20,PROD006,Guangzhou,9,1279,1270
2024-10-21,PROD013,Guangzhou,4,764,760
2024-10-22,PROD011,Shanghai,3,694,691
2024-10-23,PROD018,Beijing,5,976,971
2024-10-24,PROD019,Shenzhen,7,794,787
2024-10-25,PROD011,Beijing,8,1430,1422
2024-10-26,PROD004,Beijing,9,787,778
2024-10-27,PROD005,Guangzhou,7,535,528
2024-10-28,PROD006,Jilin,2,899,897
2024-10-29,PROD001,Beijing,9,418,409
2024-10-30,PROD004,Guangzhou,5,1316,1311
2024-10-31,PROD019,Shanghai,9,1110,1101
2024-11-01,PROD009,Shanghai,4,614,610
2024-11-02,PROD017,Beijing,7,1228,1221
2024-11-03,PROD002,Jilin,5,966,961
2024-11-04,PROD001,Guangzhou,8,1168,1160
2024-11-05,PROD009,Shanghai,4,610,606
2024-11-06,PROD014,Guangzhou,3,425,422
2024-11-07,PROD019,Shenzhen,5,787,782
2024-11-08,PROD007,Jilin,9,444,435
2024-11-09,PROD013,Shanghai,3,1053,1050
2024-11-10,PROD005,Shenzhen,3,672,669
2024-11-11,PROD004,Beijing,2,778,776
2024-11-12,PROD007,Beijing,7,408,401
2024-11-13,PROD020,Beijing,7,1105,1098
2024-11-14,PROD011,Shanghai,7,691,684
2024-11-15,PROD002,Beijing,2,964,962
2024-11-16,PROD009,Shenzhen,1,638,637
2024-11-17,PROD009,Beijing,7,573,566
2024-11-18,PROD011,Beijing,4,1422,1418
2024-11-19,PROD002,Guangzhou,10,1054,1044
2024-11-20,PROD004,Jilin,10,476,466
2024-11-21,PROD018,Guangzhou,4,1074,1070
2024-11-22,PROD011,Guangzhou,6,850,844
2024-11-23,PROD016,Shanghai,10,1193,1183
2024-11-24,PROD017,Shanghai,9,842,833
2024-11-25,PROD003,Shenzhen,7,1066,1059
2024-11-26,PROD020,Beijing,1,1098,1097
2024-11-27,PROD017,Shenzhen,2,910,908
2024-11-28,PROD001,Beijing,8,409,401
2024-11-29,PROD016,Guangzhou,9,445,436
2024-11-30,PROD014,Beijing,5,597,592
2024-12-01,PROD005,Jilin,6,830,824
2024-12-02,PROD013,Beijing,5,1109,1104
2024-12-03,PROD006,Shanghai,4,477,473
2024-12-04,PROD020,Shanghai,5,500,495
2024-12-05,PROD001,Jilin,8,535,527
2024-12-06,PROD002,Shenzhen,10,1244,1234
2024-12-07,PROD017,Jilin,6,1176,1170
2024-12-08,PROD015,Beijing,9,931,922
2024-12-09,PROD001,Guangzhou,3,1160,1157
2024-12-10,PROD015,Shanghai,1,477,476
2024-12-11,PROD004,Beijing,7,776,769
2024-12-12,PROD013,Jilin,1,923,922
2024-12-13,PROD012,Shenzhen,10,381,371
2024-12-14,PROD020,Beijing,2,1097,1095
2024-12-15,PROD020,Beijing,8,1095,1087
2024-12-16,PROD012,Shenzhen,8,371,363
2024-12-17,PROD008,Jilin,2,648,646
2024-12-18,PROD012,Guangzhou,2,511,509
2024-12-19,PROD020,Shanghai,6,495,489
2024-12-20,PROD020,Guangzhou,9,602,593
2024-12-21,PROD007,Beijing,9,401,392
2024-12-22,PROD017,Shanghai,9,833,824
2024-12-23,PROD007,Jilin,4,435,431
2024-12-24,PROD005,Jilin,4,824,820
2024-12-25,PROD004,Beijing,2,769,767
2024-12-26,PROD003,Shanghai,3,1155,1152
2024-12-27,PROD008,Guangzhou,10,1352,1342
2024-12-28,PROD006,Shenzhen,6,484,478
2024-12-29,PROD006,Shenzhen,10,478,468
2024-12-30,PROD015,Shenzhen,5,894,889
2024-01-01,PROD010,Shenzhen,5,960,955
2024-01-02,PROD003,Shanghai,9,1152,1143
2024-01-03,PROD009,Shanghai,3,606,603
2024-01-04,PROD019,Jilin,4,936,932
2024-01-05,PROD017,Guangzhou,9,501,492
2024-01-06,PROD007,Shenzhen,5,664,659
2024-01-07,PROD015,Guangzhou,10,811,801
2024-01-08,PROD003,Jilin,2,1250,1248
2024-01-09,PROD019,Shanghai,6,1101,1095
2024-01-10,PROD008,Shenzhen,2,785,783
2024-01-11,PROD015,Guangzhou,6,801,795
2024-01-12,PROD013,Jilin,7,922,915
2024-01-13,PROD008,Guangzhou,7,1342,1335
2024-01-14,PROD008,Shanghai,6,529,523
2024-01-15,PROD006,Guangzhou,9,1270,1261
2024-01-16,PROD007,Beijing,10,392,382
2024-01-17,PROD003,Guangzhou,5,1069,1064
2024-01-18,PROD007,Beijing,9,382,373
2024-01-19,PROD020,Shenzhen,6,1150,1144
2024-01-20,PROD017,Beijing,3,1221,1218
2024-01-21,PROD006,Beijing,5,944,939
2024-01-22,PROD006,Beijing,5,939,934
2024-01-23,PROD016,Beijing,1,1216,1215
2024-01-24,PROD008,Shanghai,4,523,519
2024-01-25,PROD019,Shanghai,8,1095,1087
2024-01-26,PROD001,Beijing,6,401,395
2024-01-27,PROD017,Guangzhou,9,492,483
2024-01-28,PROD013,Guangzhou,6,760,754
2024-01-29,PROD006,Shanghai,9,473,464
2024-01-30,PROD010,Beijing,8,1346,1338
2024-01-31,PROD004,Guangzhou,8,1311,1303
2024-02-01,PROD011,Guangzhou,2,844,842
2024-02-02,PROD014,Shanghai,10,690,680
2024-02-03,PROD011,Guangzhou,2,842,840
2024-02-04,PROD012,Shanghai,7,877,870
2024-02-05,PROD009,Jilin,6,480,474
2024-02-06,PROD007,Shenzhen,4,659,655
2024-02-07,PROD014,Shenzhen,4,720,716
2024-02-08,PROD005,Beijing,8,757,749
2024-02-09,PROD010,Beijing,6,1338,1332
2024-02-10,PROD008,Shanghai,1,519,518
2024-02-11,PROD002,Shenzhen,10,1234,1224
2024-02-12,PROD014,Shenzhen,1,716,715
2024-02-13,PROD013,Jilin,9,915,906
2024-02-14,PROD003,Shenzhen,6,1059,1053
2024-02-15,PROD006,Guangzhou,8,1261,1253
2024-02-16,PROD012,Shenzhen,2,363,361
2024-02-17,PROD006,Jilin,7,897,890
2024-02-18,PROD006,Guangzhou,2,1253,1251
2024-02-19,PROD004,Shenzhen,4,502,498
2024-02-20,PROD004,Shenzhen,9,498,489
2024-02-21,PROD015,Beijing,6,922,916
2024-02-22,PROD012,Guangzhou,8,509,501
2024-02-23,PROD008,Guangzhou,6,1335,1329
2024-02-24,PROD003,Shenzhen,4,1053,1049
2024-02-25,PROD016,Jilin,10,777,767
2024-02-26,PROD019,Jilin,7,932,925
2024-02-27,PROD015,Shanghai,6,476,470
2024-02-28,PROD010,Jilin,9,510,501
2024-02-29,PROD007,Jilin,10,431,421
2024-03-01,PROD013,Beijing,1,1104,1103
2024-03-02,PROD003,Guangzhou,3,1064,1061
2024-03-03,PROD017,Shanghai,8,824,816
2024-03-04,PROD005,Jilin,8,820,812
2024-03-05,PROD001,Shenzhen,1,676,675
2024-03-06,PROD007,Beijing,1,373,372
2024-03-07,PROD014,Guangzhou,7,422,415
2024-03-08,PROD020,Jilin,10,1237,1227
2024-03-09,PROD007,Jilin,7,421,414
2024-03-10,PROD004,Shanghai,1,1291,1290
2024-03-11,PROD018,Shenzhen,3,1122,1119
2024-03-12,PROD003,Beijing,5,1358,1353
2024-03-13,PROD002,Shenzhen,8,1224,1216
2024-03-14,PROD011,Beijing,8,1418,1410
2024-03-15,PROD003,Guangzhou,5,1061,1056
2024-03-16,PROD004,Shanghai,5,1290,1285
2024-03-17,PROD014,Beijing,1,592,591
2024-03-18,PROD019,Shenzhen,7,782,775
2024-03-19,PROD007,Guangzhou,3,1005,1002
2024-03-20,PROD007,Shenzhen,4,655,651
2024-03-21,PROD004,Jilin,9,466,457
2024-03-22,PROD010,Guangzhou,7,1334,1327
2024-03-23,PROD006,Jilin,2,890,888
2024-03-24,PROD015,Jilin,7,1075,1068
2024-03-25,PROD015,Beijing,2,916,914
2024-03-26,PROD016,Beijing,3,1215,1212
2024-03-27,PROD005,Jilin,4,812,808
2024-03-28,PROD019,Guangzhou,1,1215,1214
2024-03-29,PROD002,Shanghai,10,571,561
2024-03-30,PROD005,Shenzhen,9,669,660
2024-03-31,PROD007,Jilin,5,414,409
2024-04-01,PROD017,Shanghai,10,816,806
2024-04-02,PROD005,Beijing,7,749,742
2024-04-03,PROD006,Shanghai,8,464,456
2024-04-04,PROD011,Shenzhen,8,957,949
2024-04-05,PROD002,Shanghai,9,561,552
2024-04-06,PROD017,Shenzhen,9,908,899
2024-04-07,PROD012,Shenzhen,2,361,359
2024-04-08,PROD006,Jilin,7,888,881
2024-04-09,PROD001,Shanghai,8,1053,1045
2024-04-10,PROD019,Guangzhou,5,1214,1209
2024-04-11,PROD010,Beijing,8,1332,1324
2024-04-12,PROD013,Shanghai,10,1050,1040
2024-04-13,PROD016,Guangzhou,1,436,435
2024-04-14,PROD006,Jilin,3,881,878
2024-04-15,PROD005,Jilin,1,808,807
2024-04-16,PROD015,Jilin,1,1068,1067
2024-04-17,PROD014,Guangzhou,6,415,409
2024-04-18,PROD007,Beijing,10,372,362
2024-04-19,PROD012,Guangzhou,1,501,500
2024-04-20,PROD019,Beijing,3,704,701
2024-04-21,PROD005,Shenzhen,7,660,653
2024-04-22,PROD020,Guangzhou,3,593,590
2024-04-23,PROD019,Shanghai,2,1087,1085
2024-04-24,PROD018,Beijing,7,971,964
2024-04-25,PROD012,Guangzhou,1,500,499
2024-04-26,PROD010,Shanghai,7,693,686
2024-04-27,PROD013,Shanghai,6,1040,1034
2024-04-28,PROD019,Shanghai,8,1085,1077
2024-04-29,PROD014,Beijing,9,591,582
2024-04-30,PROD007,Beijing,9,362,353
2024-05-01,PROD002,Beijing,6,962,956
2024-05-02,PROD010,Shanghai,4,686,682
2024-05-03,PROD005,Beijing,10,742,732
2024-05-04,PROD001,Jilin,1,527,526
2024-05-05,PROD001,Guangzhou,5,1157,1152
2024-05-06,PROD004,Guangzhou,7,1303,1296
2024-05-07,PROD008,Shanghai,3,518,515
2024-05-08,PROD017,Beijing,8,1218,1210
2024-05-09,PROD016,Guangzhou,9,435,426
2024-05-10,PROD008,Shenzhen,8,783,775
2024-05-11,PROD004,Shenzhen,6,489,483
2024-05-12,PROD013,Guangzhou,9,754,745
2024-05-13,PROD019,Jilin,9,925,916
2024-05-14,PROD001,Shanghai,9,1045,1036
2024-05-15,PROD003,Shenzhen,8,1049,1041
2024-05-16,PROD016,Jilin,2,767,765
2024-05-17,PROD013,Jilin,10,906,896
2024-05-18,PROD015,Guangzhou,10,795,785
2024-05-19,PROD009,Guangzhou,8,1213,1205
2024-05-20,PROD008,Shanghai,10,515,505
2024-05-21,PROD002,Shenzhen,7,1216,1209
2024-05-22,PROD012,Shenzhen,2,359,357
2024-05-23,PROD002,Shenzhen,8,1209,1201
2024-05-24,PROD002,Guangzhou,8,1044,1036
2024-05-25,PROD003,Beijing,10,1353,1343
2024-05-26,PROD017,Shenzhen,4,899,895
2024-05-27,PROD010,Jilin,10,501,491
2024-05-28,PROD010,Jilin,9,491,482
2024-05-29,PROD007,Guangzhou,10,1002,992
2024-05-30,PROD020,Jilin,2,1227,1225
2024-05-31,PROD011,Shenzhen,7,949,942
2024-06-01,PROD004,Shanghai,1,1285,1284
2024-06-02,PROD014,Shenzhen,4,715,711
2024-06-03,PROD014,Shenzhen,8,711,703
2024-06-04,PROD013,Shanghai,7,1034,1027
2024-06-05,PROD009,Beijing,7,566,559
2024-06-06,PROD001,Beijing,6,395,389
2024-06-07,PROD004,Jilin,10,457,447
2024-06-08,PROD007,Shenzhen,9,651,642
2024-06-09,PROD009,Guangzhou,7,1205,1198
2024-06-10,PROD016,Beijing,1,1212,1211
2024-06-11,PROD012,Guangzhou,8,499,491
2024-06-12,PROD016,Shenzhen,6,449,443
2024-06-13,PROD011,Shanghai,2,684,682
2024-06-14,PROD016,Guangzhou,9,426,417
2024-06-15,PROD013,Guangzhou,6,745,739
2024-06-16,PROD014,Guangzhou,3,409,406
2024-06-17,PROD018,Beijing,7,964,957
2024-06-18,PROD003,Jilin,3,1248,1245
2024-06-19,PROD003,Beijing,4,1343,1339
2024-06-20,PROD004,Guangzhou,4,1296,1292
2024-06-21,PROD015,Shenzhen,10,889,879
2024-06-22,PROD019,Jilin,8,916,908
2024-06-23,PROD017,Beijing,3,1210,1207
2024-06-24,PROD006,Shenzhen,3,468,465
2024-06-25,PROD011,Guangzhou,8,840,832
2024-06-26,PROD003,Shanghai,5,1143,1138
2024-06-27,PROD003,Beijing,2,1339,1337
2024-06-28,PROD001,Shenzhen,8,675,667
2024-06-29,PROD019,Shenzhen,5,775,770
2024-06-30,PROD014,Jilin,8,767,759
2024-07-01,PROD011,Beijing,2,1410,1408
2024-07-02,PROD019,Beijing,5,701,696
2024-07-03,PROD011,Jilin,10,543,533
2024-07-04,PROD008,Jilin,1,646,645
2024-07-05,PROD007,Jilin,6,409,403
2024-07-06,PROD012,Guangzhou,4,491,487
2024-07-07,PROD013,Jilin,9,896,887
2024-07-08,PROD009,Jilin,1,474,473
2024-07-09,PROD011,Beijing,2,1408,1406
2024-07-10,PROD001,Beijing,8,389,381
2024-07-11,PROD016,Shanghai,5,1183,1178
2024-07-12,PROD012,Beijing,10,1151,1141
2024-07-13,PROD009,Guangzhou,2,1198,1196
2024-07-14,PROD017,Shanghai,10,806,796
2024-07-15,PROD012,Guangzhou,3,487,484
2024-07-16,PROD020,Shanghai,8,489,481
2024-07-17,PROD006,Guangzhou,10,1251,1241
2024-07-18,PROD002,Beijing,6,956,950
2024-07-19,PROD002,Jilin,3,961,958
2024-07-20,PROD004,Shenzhen,4,483,479
2024-07-21,PROD009,Guangzhou,10,1196,1186
2024-07-22,PROD008,Beijing,1,497,496
2024-07-23,PROD013,Guangzhou,4,739,735
2024-07-24,PROD013,Jilin,3,887,884
2024-07-25,PROD013,Shenzhen,2,1267,1265
2024-07-26,PROD001,Jilin,1,526,525
2024-07-27,PROD007,Jilin,4,403,399
2024-07-28,PROD005,Beijing,2,732,730
2024-07-29,PROD011,Beijing,6,1406,1400
2024-07-30,PROD005,Guangzhou,4,528,524
2024-07-31,PROD013,Guangzhou,8,735,727
2024-08-01,PROD020,Shanghai,2,481,479
2024-08-02,PROD012,Guangzhou,5,484,479
2024-08-03,PROD007,Beijing,7,353,346
2024-08-04,PROD009,Beijing,5,559,554
2024-08-05,PROD008,Beijing,4,496,492
2024-08-06,PROD004,Guangzhou,1,1292,1291
2024-08-07,PROD007,Beijing,10,346,336
2024-08-08,PROD010,Shanghai,10,682,672
2024-08-09,PROD020,Jilin,7,1225,1218
2024-08-10,PROD012,Shanghai,2,870,868
2024-08-11,PROD004,Guangzhou,5,1291,1286
2024-08-12,PROD007,Shanghai,9,616,607
2024-08-13,PROD014,Jilin,8,759,751
2024-08-14,PROD018,Shanghai,5,973,968
2024-08-15,PROD011,Guangzhou,1,832,831
2024-08-16,PROD009,Shenzhen,2,637,635
2024-08-17,PROD002,Shenzhen,4,1201,1197
2024-08-18,PROD007,Beijing,1,336,335
2024-08-19,PROD003,Beijing,2,1337,1335
2024-08-20,PROD019,Jilin,3,908,905
2024-08-21,PROD015,Shanghai,5,470,465
2024-08-22,PROD003,Shenzhen,3,1041,1038
2024-08-23,PROD005,Shanghai,6,856,850
2024-08-24,PROD016,Jilin,9,765,756
2024-08-25,PROD013,Shanghai,5,1027,1022
2024-08-26,PROD014,Beijing,9,582,573
2024-08-27,PROD010,Shanghai,8,672,664
2024-08-28,PROD016,Guangzhou,6,417,411
2024-08-29,PROD006,Shanghai,5,456,451
2024-08-30,PROD003,Jilin,10,1245,1235
2024-08-31,PROD002,Shanghai,1,552,551
2024-09-01,PROD019,Beijing,3,696,693
2024-09-02,PROD013,Shenzhen,10,1265,1255
2024-09-03,PROD006,Beijing,7,934,927
2024-09-04,PROD014,Shenzhen,10,703,693
2024-09-05,PROD011,Shanghai,10,682,672
2024-09-06,PROD004,Guangzhou,5,1286,1281
2024-09-07,PROD012,Beijing,4,1141,1137
2024-09-08,PROD012,Jilin,6,928,922
2024-09-09,PROD018,Jilin,2,1397,1395
2024-09-10,PROD008,Shanghai,8,505,497
2024-09-11,PROD013,Beijing,2,1103,1101
2024-09-12,PROD012,Beijing,9,1137,1128
2024-09-13,PROD003,Shanghai,8,1138,1130
2024-09-14,PROD003,Guangzhou,6,1056,1050
2024-09-15,PROD018,Shenzhen,8,1119,1111
2024-09-16,PROD005,Guangzhou,6,524,518
2024-09-17,PROD017,Shanghai,6,796,790
2024-09-18,PROD015,Beijing,5,914,909
2024-09-19,PROD002,Beijing,6,950,944
2024-09-20,PROD017,Jilin,8,1170,1162
2024-09-21,PROD020,Beijing,3,1087,1084
2024-09-22,PROD019,Shanghai,1,1077,1076
2024-09-23,PROD004,Jilin,8,447,439
2024-09-24,PROD013,Shanghai,3,1022,1019
2024-09-25,PROD017,Shanghai,1,790,789
2024-09-26,PROD017,Beijing,5,1207,1202
2024-09-27,PROD007,Beijing,5,335,330
2024-09-28,PROD010,Jilin,9,482,473
2024-09-29,PROD003,Jilin,4,1235,1231
2024-09-30,PROD007,Beijing,1,330,329
2024-10-01,PROD020,Shanghai,10,479,469
2024-10-02,PROD015,Beijing,8,909,901
2024-10-03,PROD020,Beijing,1,1084,1083
2024-10-04,PROD014,Jilin,2,751,749
2024-10-05,PROD012,Shenzhen,1,357,356
2024-10-06,PROD015,Beijing,6,901,895
2024-10-07,PROD003,Shanghai,6,1130,1124
2024-10-08,PROD004,Jilin,10,439,429
2024-10-09,PROD008,Guangzhou,9,1329,1320
2024-10-10,PROD011,Shanghai,3,672,669
2024-10-11,PROD008,Guangzhou,10,1320,1310
2024-10-12,PROD014,Shenzhen,3,693,690
2024-10-13,PROD005,Shanghai,6,850,844
2024-10-14,PROD004,Shanghai,2,1284,1282
2024-10-15,PROD011,Shanghai,6,669,663
2024-10-16,PROD012,Beijing,9,1128,1119
2024-10-17,PROD015,Shanghai,5,465,460
2024-10-18,PROD012,Beijing,8,1119,1111
2024-10-19,PROD010,Shenzhen,6,955,949
2024-10-20,PROD017,Shanghai,7,789,782
2024-10-21,PROD013,Jilin,3,884,881
2024-10-22,PROD017,Shenzhen,4,895,891
2024-10-23,PROD011,Jilin,6,533,527
2024-10-24,PROD015,Guangzhou,5,785,780
2024-10-25,PROD010,Guangzhou,4,1327,1323
2024-10-26,PROD007,Jilin,9,399,390
2024-10-27,PROD002,Shenzhen,1,1197,1196
2024-10-28,PROD020,Jilin,8,1218,1210
2024-10-29,PROD014,Shenzhen,1,690,689
2024-10-30,PROD020,Shenzhen,7,1144,1137
2024-10-31,PROD003,Beijing,10,1335,1325
2024-11-01,PROD003,Beijing,5,1325,1320
2024-11-02,PROD010,Guangzhou,7,1323,1316
2024-11-03,PROD007,Shenzhen,9,642,633
2024-11-04,PROD009,Shenzhen,2,635,633
2024-11-05,PROD002,Shenzhen,9,1196,1187
2024-11-06,PROD018,Beijing,7,957,950
2024-11-07,PROD015,Beijing,3,895,892
2024-11-08,PROD019,Jilin,2,905,903
2024-11-09,PROD017,Shanghai,6,782,776
2024-11-10,PROD017,Beijing,6,1202,1196
2024-11-11,PROD002,Shenzhen,6,1187,1181
2024-11-12,PROD010,Jilin,1,473,472
2024-11-13,PROD015,Beijing,2,892,890
2024-11-14,PROD005,Beijing,10,730,720
2024-11-15,PROD020,Shanghai,8,469,461
2024-11-16,PROD012,Shanghai,8,868,860
2024-11-17,PROD004,Beijing,2,767,765
2024-11-18,PROD003,Guangzhou,1,1050,1049
2024-11-19,PROD015,Shenzhen,8,879,871
2024-11-20,PROD015,Beijing,10,890,880
2024-11-21,PROD019,Jilin,1,903,902
2024-11-22,PROD012,Jilin,6,922,916
2024-11-23,PROD016,Jilin,5,756,751
2024-11-24,PROD013,Shanghai,7,1019,1012
2024-11-25,PROD011,Guangzhou,6,831,825
2024-11-26,PROD004,Jilin,6,429,423
2024-11-27,PROD007,Jilin,7,390,383
2024-11-28,PROD007,Shenzhen,10,633,623
2024-11-29,PROD008,Shenzhen,9,775,766
2024-11-30,PROD007,Shenzhen,10,623,613
2024-12-01,PROD005,Shanghai,9,844,835
2024-12-02,PROD002,Guangzhou,6,1036,1030
2024-12-03,PROD004,Jilin,9,423,414
2024-12-04,PROD015,Jilin,1,1067,1066
2024-12-05,PROD011,Guangzhou,7,825,818
2024-12-06,PROD009,Jilin,8,473,465
2024-12-07,PROD009,Shenzhen,4,633,629
2024-12-08,PROD010,Guangzhou,3,1316,1313
2024-12-09,PROD011,Jilin,5,527,522
2024-12-10,PROD008,Jilin,1,645,644
2024-12-11,PROD003,Guangzhou,10,1049,1039
2024-12-12,PROD016,Jilin,2,751,749
2024-12-13,PROD008,Jilin,1,644,643
2024-12-14,PROD011,Shenzhen,9,942,933
2024-12-15,PROD015,Shanghai,9,460,451
2024-12-16,PROD016,Shenzhen,3,443,440
2024-12-17,PROD007,Jilin,6,383,377
2024-12-18,PROD017,Beijing,8,1196,1188
2024-12-19,PROD009,Shenzhen,6,629,623
2024-12-20,PROD009,Beijing,1,554,553
2024-12-21,PROD008,Shenzhen,4,766,762
2024-12-22,PROD011,Guangzhou,4,818,814
2024-12-23,PROD014,Guangzhou,5,406,401
2024-12-24,PROD019,Guangzhou,1,1209,1208
2024-12-25,PROD020,Guangzhou,6,590,584
2024-12-26,PROD015,Shanghai,1,451,450
2024-12-27,PROD002,Shanghai,6,551,545
2024-12-28,PROD019,Jilin,3,902,899
2024-12-29,PROD007,Jilin,6,377,371
2024-12-30,PROD013,Shenzhen,1,1255,1254
2024-01-01,PROD009,Shanghai,1,603,602
2024-01-02,PROD005,Shanghai,2,835,833
2024-01-03,PROD018,Guangzhou,7,1070,1063
2024-01-04,PROD004,Beijing,7,765,758
2024-01-05,PROD019,Shanghai,9,1076,1067
2024-01-06,PROD011,Beijing,10,1400,1390
2024-01-07,PROD018,Shanghai,9,968,959
2024-01-08,PROD007,Shanghai,3,607,604
2024-01-09,PROD011,Guangzhou,7,814,807
2024-01-10,PROD001,Beijing,2,381,379
2024-01-11,PROD004,Beijing,3,758,755
2024-01-12,PROD018,Guangzhou,10,1063,1053
2024-01-13,PROD014,Shanghai,9,680,671
2024-01-14,PROD002,Guangzhou,6,1030,1024
2024-01-15,PROD014,Shanghai,6,671,665
2024-01-16,PROD003,Beijing,4,1320,1316
2024-01-17,PROD001,Beijing,8,379,371
2024-01-18,PROD005,Jilin,3,807,804
2024-01-19,PROD019,Beijing,5,693,688
2024-01-20,PROD015,Guangzhou,7,780,773
2024-01-21,PROD015,Guangzhou,7,773,766
2024-01-22,PROD012,Shenzhen,7,356,349
2024-01-23,PROD005,Shanghai,9,833,824
2024-01-24,PROD016,Guangzhou,5,411,406
2024-01-25,PROD010,Jilin,9,472,463
2024-01-26,PROD009,Shanghai,4,602,598
2024-01-27,PROD018,Jilin,7,1395,1388
2024-01-28,PROD001,Shanghai,7,1036,1029
2024-01-29,PROD018,Guangzhou,7,1053,1046
2024-01-30,PROD009,Shenzhen,6,623,617
2024-01-31,PROD015,Guangzhou,9,766,757
2024-02-01,PROD011,Jilin,2,522,520
2024-02-02,PROD013,Jilin,9,881,872
2024-02-03,PROD015,Shenzhen,6,871,865
2024-02-04,PROD015,Guangzhou,2,757,755
2024-02-05,PROD012,Guangzhou,3,479,476
2024-02-06,PROD007,Jilin,7,371,364
2024-02-07,PROD019,Beijing,2,688,686
2024-02-08,PROD011,Jilin,8,520,512
2024-02-09,PROD008,Shenzhen,4,762,758
2024-02-10,PROD013,Shenzhen,7,1254,1247
2024-02-11,PROD020,Guangzhou,1,584,583
2024-02-12,PROD011,Beijing,4,1390,1386
2024-02-13,PROD018,Shanghai,10,959,949
2024-02-14,PROD003,Guangzhou,4,1039,1035
2024-02-15,PROD008,Shanghai,7,497,490
2024-02-16,PROD008,Shanghai,9,490,481
2024-02-17,PROD014,Guangzhou,8,401,393
2024-02-18,PROD005,Jilin,6,804,798
2024-02-19,PROD019,Shanghai,6,1067,1061
2024-02-20,PROD012,Jilin,8,916,908
2024-02-21,PROD007,Jilin,6,364,358
2024-02-22,PROD006,Guangzhou,7,1241,1234
2024-02-23,PROD005,Shanghai,10,824,814
2024-02-24,PROD001,Jilin,3,525,522
2024-02-25,PROD011,Beijing,6,1386,1380
2024-02-26,PROD005,Shenzhen,4,653,649
2024-02-27,PROD016,Shanghai,7,1178,1171
2024-02-28,PROD001,Shanghai,2,1029,1027
2024-02-29,PROD007,Shanghai,1,604,603
2024-03-01,PROD004,Guangzhou,3,1281,1278
2024-03-02,PROD011,Shanghai,10,663,653
2024-03-03,PROD019,Shenzhen,4,770,766
2024-03-04,PROD009,Jilin,7,465,458
2024-03-05,PROD008,Shanghai,6,481,475
2024-03-06,PROD003,Shenzhen,2,1038,1036
2024-03-07,PROD003,Shenzhen,4,1036,1032
2024-03-08,PROD013,Guangzhou,4,727,723
2024-03-09,PROD006,Shenzhen,3,465,462
2024-03-10,PROD012,Jilin,1,908,907
2024-03-11,PROD010,Shenzhen,4,949,945
2024-03-12,PROD002,Shenzhen,7,1181,1174
2024-03-13,PROD003,Shenzhen,5,1032,1027
2024-03-14,PROD017,Jilin,9,1162,1153
2024-03-15,PROD019,Jilin,9,899,890
2024-03-16,PROD004,Guangzhou,5,1278,1273
2024-03-17,PROD009,Jilin,6,458,452
2024-03-18,PROD004,Jilin,3,414,411
2024-03-19,PROD002,Guangzhou,1,1024,1023
2024-03-20,PROD008,Beijing,2,492,490
2024-03-21,PROD006,Shanghai,4,451,447
2024-03-22,PROD005,Guangzhou,7,518,511
2024-03-23,PROD002,Beijing,5,944,939
2024-03-24,PROD006,Beijing,6,927,921
2024-03-25,PROD007,Beijing,6,329,323
2024-03-26,PROD018,Shenzhen,8,1111,1103
2024-03-27,PROD006,Guangzhou,5,1234,1229
2024-03-28,PROD002,Jilin,10,958,948
2024-03-29,PROD011,Shanghai,5,653,648
2024-03-30,PROD013,Jilin,5,872,867
2024-03-31,PROD010,Beijing,7,1324,1317
2024-04-01,PROD001,Beijing,8,371,363
2024-04-02,PROD018,Beijing,8,950,942
2024-04-03,PROD002,Guangzhou,8,1023,1015
2024-04-04,PROD013,Guangzhou,7,723,716
2024-04-05,PROD015,Shanghai,2,450,448
2024-04-06,PROD006,Beijing,8,921,913
2024-04-07,PROD002,Beijing,1,939,938
2024-04-08,PROD017,Guangzhou,9,483,474
2024-04-09,PROD010,Jilin,9,463,454
2024-04-10,PROD004,Shenzhen,2,479,477
2024-04-11,PROD019,Shenzhen,9,766,757
2024-04-12,PROD016,Shanghai,9,1171,1162
2024-04-13,PROD020,Shanghai,1,461,460
2024-04-14,PROD014,Shenzhen,4,689,685
2024-04-15,PROD012,Shenzhen,3,349,346
2024-04-16,PROD007,Beijing,4,323,319
2024-04-17,PROD010,Guangzhou,7,1313,1306
2024-04-18,PROD010,Guangzhou,6,1306,1300
2024-04-19,PROD020,Beijing,8,1083,1075
2024-04-20,PROD006,Shanghai,5,447,442
2024-04-21,PROD009,Jilin,8,452,444
2024-04-22,PROD002,Shenzhen,6,1174,1168
2024-04-23,PROD007,Guangzhou,10,992,982
2024-04-24,PROD002,Shanghai,7,545,538
2024-04-25,PROD009,Jilin,1,444,443
2024-04-26,PROD007,Shenzhen,10,613,603
2024-04-27,PROD009,Shanghai,3,598,595
2024-04-28,PROD007,Shanghai,9,603,594
2024-04-29,PROD015,Shenzhen,5,865,860
2024-04-30,PROD017,Guangzhou,7,474,467
2024-05-01,PROD019,Shenzhen,9,757,748
2024-05-02,PROD004,Beijing,4,755,751
2024-05-03,PROD001,Shenzhen,6,667,661
2024-05-04,PROD002,Guangzhou,1,1015,1014
2024-05-05,PROD009,Shenzhen,8,617,609
2024-05-06,PROD014,Guangzhou,1,393,392
2024-05-07,PROD004,Beijing,9,751,742
2024-05-08,PROD014,Jilin,3,749,746
2024-05-09,PROD010,Guangzhou,6,1300,1294
2024-05-10,PROD003,Jilin,6,1231,1225
2024-05-11,PROD011,Shanghai,6,648,642
2024-05-12,PROD017,Jilin,4,1153,1149
2024-05-13,PROD017,Guangzhou,1,467,466
2024-05-14,PROD017,Shenzhen,10,891,881
2024-05-15,PROD008,Jilin,3,643,640
2024-05-16,PROD018,Jilin,3,1388,1385
2024-05-17,PROD006,Guangzhou,5,1229,1224
2024-05-18,PROD013,Guangzhou,6,716,710
2024-05-19,PROD013,Shanghai,2,1012,1010
2024-05-20,PROD005,Guangzhou,3,511,508
2024-05-21,PROD012,Shanghai,8,860,852
2024-05-22,PROD008,Guangzhou,1,1310,1309
2024-05-23,PROD002,Shanghai,5,538,533
2024-05-24,PROD010,Jilin,5,454,449
2024-05-25,PROD018,Shanghai,7,949,942
2024-05-26,PROD007,Guangzhou,3,982,979
2024-05-27,PROD019,Jilin,3,890,887
2024-05-28,PROD014,Beijing,3,573,570
2024-05-29,PROD020,Beijing,5,1075,1070
2024-05-30,PROD009,Jilin,8,443,435
2024-05-31,PROD016,Beijing,10,1211,1201
2024-06-01,PROD006,Guangzhou,8,1224,1216
2024-06-02,PROD001,Shenzhen,9,661,652
2024-06-03,PROD017,Guangzhou,7,466,459
2024-06-04,PROD019,Shanghai,9,1061,1052
2024-06-05,PROD017,Beijing,4,1188,1184
2024-06-06,PROD014,Guangzhou,1,392,391
2024-06-07,PROD006,Guangzhou,6,1216,1210
2024-06-08,PROD003,Beijing,5,1316,1311
2024-06-09,PROD020,Guangzhou,3,583,580
2024-06-10,PROD008,Shanghai,7,475,468
2024-06-11,PROD006,Guangzhou,2,1210,1208
2024-06-12,PROD017,Guangzhou,7,459,452
2024-06-13,PROD012,Guangzhou,6,476,470
2024-06-14,PROD002,Shenzhen,1,1168,1167
2024-06-15,PROD014,Shanghai,7,665,658
2024-06-16,PROD015,Guangzhou,6,755,749
2024-06-17,PROD007,Beijing,4,319,315
2024-06-18,PROD017,Guangzhou,6,452,446
2024-06-19,PROD019,Guangzhou,5,1208,1203
2024-06-20,PROD014,Shenzhen,8,685,677
2024-06-21,PROD018,Shenzhen,5,1103,1098
2024-06-22,PROD009,Jilin,6,435,429
2024-06-23,PROD001,Shanghai,3,1027,1024
2024-06-24,PROD003,Beijing,6,1311,1305
2024-06-25,PROD007,Beijing,6,315,309
2024-06-26,PROD020,Jilin,2,1210,1208
2024-06-27,PROD010,Shanghai,1,664,663
2024-06-28,PROD006,Shenzhen,8,462,454
2024-06-29,PROD012,Jilin,6,907,901
2024-06-30,PROD002,Guangzhou,6,1014,1008
2024-07-01,PROD008,Beijing,6,490,484
2024-07-02,PROD003,Shanghai,8,1124,1116
2024-07-03,PROD019,Shenzhen,7,748,741
2024-07-04,PROD004,Guangzhou,4,1273,1269
2024-07-05,PROD015,Guangzhou,10,749,739
2024-07-06,PROD010,Jilin,3,449,446
2024-07-07,PROD013,Guangzhou,7,710,703
2024-07-08,PROD006,Shenzhen,6,454,448
2024-07-09,PROD002,Guangzhou,3,1008,1005
2024-07-10,PROD007,Guangzhou,1,979,978
2024-07-11,PROD006,Jilin,9,878,869
2024-07-12,PROD006,Beijing,1,913,912
2024-07-13,PROD012,Beijing,1,1111,1110
2024-07-14,PROD017,Shenzhen,10,881,871
2024-07-15,PROD013,Shenzhen,9,1247,1238
2024-07-16,PROD002,Beijing,1,938,937
2024-07-17,PROD020,Shenzhen,3,1137,1134
2024-07-18,PROD010,Shanghai,8,663,655
2024-07-19,PROD011,Guangzhou,8,807,799
2024-07-20,PROD007,Shanghai,5,594,589
2024-07-21,PROD006,Shenzhen,6,448,442
2024-07-22,PROD013,Guangzhou,10,703,693
2024-07-23,PROD003,Beijing,2,1305,1303
2024-07-24,PROD008,Beijing,8,484,476
2024-07-25,PROD013,Shenzhen,4,1238,1234
2024-07-26,PROD020,Shanghai,4,460,456
2024-07-27,PROD018,Beijing,5,942,937
2024-07-28,PROD001,Shanghai,7,1024,1017
2024-07-29,PROD010,Guangzhou,3,1294,1291
2024-07-30,PROD010,Guangzhou,1,1291,1290
2024-07-31,PROD004,Jilin,5,411,406
2024-08-01,PROD018,Guangzhou,2,1046,1044
2024-08-02,PROD002,Shenzhen,9,1167,1158
2024-08-03,PROD007,Shenzhen,9,603,594
2024-08-04,PROD012,Shanghai,4,852,848
2024-08-05,PROD011,Beijing,3,1380,1377
2024-08-06,PROD016,Shenzhen,7,440,433
2024-08-07,PROD016,Jilin,3,749,746
2024-08-08,PROD009,Jilin,7,429,422
2024-08-09,PROD014,Beijing,5,570,565
2024-08-10,PROD008,Beijing,4,476,472
2024-08-11,PROD009,Shanghai,9,595,586
2024-08-12,PROD009,Jilin,2,422,420
2024-08-13,PROD004,Beijing,6,742,736
2024-08-14,PROD015,Shanghai,3,448,445
2024-08-15,PROD014,Guangzhou,7,391,384
2024-08-16,PROD002,Jilin,5,948,943
2024-08-17,PROD020,Jilin,3,1208,1205
2024-08-18,PROD002,Beijing,2,937,935
2024-08-19,PROD014,Shanghai,3,658,655
2024-08-20,PROD007,Jilin,2,358,356
2024-08-21,PROD006,Shanghai,2,442,440
2024-08-22,PROD008,Shanghai,2,468,466
2024-08-23,PROD016,Shenzhen,8,433,425
2024-08-24,PROD011,Beijing,5,1377,1372
2024-08-25,PROD009,Shanghai,5,586,581
2024-08-26,PROD016,Beijing,6,1201,1195
2024-08-27,PROD003,Shenzhen,8,1027,1019
2024-08-28,PROD003,Shenzhen,4,1019,1015
2024-08-29,PROD006,Shenzhen,3,442,439
2024-08-30,PROD020,Beijing,6,1070,1064
2024-08-31,PROD001,Shenzhen,9,652,643
2024-09-01,PROD001,Guangzhou,10,1152,1142
2024-09-02,PROD016,Guangzhou,2,406,404
2024-09-03,PROD005,Guangzhou,8,508,500
2024-09-04,PROD013,Shenzhen,1,1234,1233
2024-09-05,PROD015,Shanghai,2,445,443
2024-09-06,PROD012,Shanghai,4,848,844
2024-09-07,PROD016,Guangzhou,10,404,394
2024-09-08,PROD013,Beijing,8,1101,1093
2024-09-09,PROD017,Guangzhou,9,446,437
2024-09-10,PROD014,Shanghai,5,655,650
2024-09-11,PROD005,Jilin,1,798,797
2024-09-12,PROD005,Shenzhen,5,649,644
2024-09-13,PROD015,Beijing,6,880,874
2024-09-14,PROD008,Shanghai,10,466,456
2024-09-15,PROD012,Guangzhou,8,470,462
2024-09-16,PROD002,Jilin,7,943,936
2024-09-17,PROD008,Shenzhen,10,758,748
2024-09-18,PROD003,Shanghai,6,1116,1110
2024-09-19,PROD002,Guangzhou,8,1005,997
2024-09-20,PROD002,Jilin,2,936,934
2024-09-21,PROD017,Shenzhen,2,871,869
2024-09-22,PROD019,Guangzhou,8,1203,1195
2024-09-23,PROD015,Shenzhen,3,860,857
2024-09-24,PROD004,Shenzhen,6,477,471
2024-09-25,PROD011,Guangzhou,2,799,797
2024-09-26,PROD007,Beijing,2,309,307
2024-09-27,PROD017,Jilin,4,1149,1145
2024-09-28,PROD018,Shanghai,1,942,941
2024-09-29,PROD017,Shenzhen,10,869,859
2024-09-30,PROD002,Jilin,8,934,926
2024-10-01,PROD001,Shanghai,9,1017,1008
2024-10-02,PROD001,Jilin,7,522,515
2024-10-03,PROD014,Shanghai,4,650,646
2024-10-04,PROD007,Shanghai,9,589,580
2024-10-05,PROD015,Guangzhou,1,739,738
2024-10-06,PROD017,Beijing,8,1184,1176
2024-10-07,PROD016,Beijing,6,1195,1189
2024-10-08,PROD007,Shenzhen,1,594,593
2024-10-09,PROD006,Shanghai,5,440,435
2024-10-10,PROD018,Shanghai,10,941,931
2024-10-11,PROD011,Guangzhou,9,797,788
2024-10-12,PROD019,Beijing,10,686,676
2024-10-13,PROD007,Shanghai,8,580,572
2024-10-14,PROD002,Shenzhen,10,1158,1148
2024-10-15,PROD011,Guangzhou,3,788,785
2024-10-16,PROD020,Shanghai,5,456,451
2024-10-17,PROD020,Jilin,7,1205,1198
2024-10-18,PROD014,Guangzhou,7,384,377
2024-10-19,PROD008,Guangzhou,6,1309,1303
2024-10-20,PROD005,Jilin,4,797,793
2024-10-21,PROD013,Jilin,5,867,862
2024-10-22,PROD007,Shenzhen,2,593,591
2024-10-23,PROD011,Shanghai,9,642,633
2024-10-24,PROD012,Guangzhou,4,462,458
2024-10-25,PROD011,Guangzhou,4,785,781
2024-10-26,PROD002,Shanghai,9,533,524
2024-10-27,PROD004,Shanghai,6,1282,1276
2024-10-28,PROD016,Shenzhen,8,425,417
2024-10-29,PROD019,Shenzhen,5,741,736
2024-10-30,PROD010,Shenzhen,1,945,944
2024-10-31,PROD006,Guangzhou,4,1208,1204
2024-11-01,PROD018,Jilin,7,1385,1378
2024-11-02,PROD005,Beijing,8,720,712
2024-11-03,PROD016,Shenzhen,2,417,415
2024-11-04,PROD010,Shanghai,3,655,652
2024-11-05,PROD008,Beijing,5,472,467
2024-11-06,PROD012,Guangzhou,6,458,452
2024-11-07,PROD016,Guangzhou,3,394,391
2024-11-08,PROD018,Jilin,6,1378,1372
2024-11-09,PROD007,Shenzhen,10,591,581
2024-11-10,PROD004,Beijing,7,736,729
2024-11-11,PROD003,Jilin,4,1225,1221
2024-11-12,PROD003,Shanghai,1,1110,1109
2024-11-13,PROD008,Shanghai,4,456,452
2024-11-14,PROD009,Beijing,8,553,545
2024-11-15,PROD018,Jilin,4,1372,1368
2024-11-16,PROD014,Jilin,9,746,737
2024-11-17,PROD004,Shenzhen,10,471,461
2024-11-18,PROD001,Shenzhen,6,643,637
2024-11-19,PROD006,Guangzhou,1,1204,1203
2024-11-20,PROD013,Beijing,1,1093,1092
2024-11-21,PROD001,Shanghai,4,1008,1004
2024-11-22,PROD009,Shanghai,3,581,578
2024-11-23,PROD019,Beijing,8,676,668
2024-11-24,PROD001,Jilin,9,515,506
2024-11-25,PROD002,Shenzhen,8,1148,1140
2024-11-26,PROD020,Guangzhou,8,580,572
2024-11-27,PROD019,Beijing,5,668,663
2024-11-28,PROD011,Beijing,7,1372,1365
2024-11-29,PROD004,Guangzhou,3,1269,1266
2024-11-30,PROD012,Shanghai,1,844,843
2024-12-01,PROD015,Jilin,3,1066,1063
2024-12-02,PROD002,Shanghai,5,524,519
2024-12-03,PROD013,Shenzhen,8,1233,1225
2024-12-04,PROD008,Jilin,7,640,633
2024-12-05,PROD006,Shenzhen,2,439,437
2024-12-06,PROD002,Shenzhen,8,1140,1132
2024-12-07,PROD015,Jilin,3,1063,1060
2024-12-08,PROD016,Guangzhou,1,391,390
2024-12-09,PROD014,Shenzhen,3,677,674
2024-12-10,PROD008,Beijing,8,467,459
2024-12-11,PROD002,Guangzhou,10,997,987
2024-12-12,PROD005,Beijing,1,712,711
2024-12-13,PROD010,Shanghai,9,652,643
2024-12-14,PROD006,Beijing,6,912,906
2024-12-15,PROD012,Shenzhen,10,346,336
2024-12-16,PROD011,Shanghai,6,633,627
2024-12-17,PROD005,Jilin,8,793,785
2024-12-18,PROD019,Beijing,9,663,654
2024-12-19,PROD011,Guangzhou,3,781,778
2024-12-20,PROD007,Beijing,4,307,303
2024-12-21,PROD016,Jilin,1,746,745
2024-12-22,PROD005,Shenzhen,10,644,634
2024-12-23,PROD003,Guangzhou,2,1035,1033
2024-12-24,PROD015,Shenzhen,2,857,855
2024-12-25,PROD020,Guangzhou,10,572,562
2024-12-26,PROD001,Jilin,2,506,504
2024-12-27,PROD001,Jilin,8,504,496
2024-12-28,PROD014,Shanghai,8,646,638
2024-12-29,PROD018,Beijing,3,937,934
2024-12-30,PROD011,Guangzhou,1,778,777
2024-01-01,PROD003,Shenzhen,9,1015,1006
2024-01-02,PROD008,Shanghai,7,452,445
2024-01-03,PROD007,Shenzhen,10,581,571
2024-01-04,PROD019,Shanghai,1,1052,1051
2024-01-05,PROD013,Guangzhou,9,693,684
2024-01-06,PROD009,Guangzhou,5,1186,1181
2024-01-07,PROD006,Guangzhou,7,1203,1196
2024-01-08,PROD012,Shenzhen,7,336,329
2024-01-09,PROD006,Beijing,4,906,902
2024-01-10,PROD008,Shanghai,2,445,443
2024-01-11,PROD014,Shanghai,1,638,637
2024-01-12,PROD001,Beijing,4,363,359
2024-01-13,PROD012,Jilin,4,901,897
2024-01-14,PROD001,Beijing,10,359,349
2024-01-15,PROD006,Shenzhen,8,437,429
2024-01-16,PROD006,Guangzhou,1,1196,1195
2024-01-17,PROD020,Jilin,1,1198,1197
2024-01-18,PROD007,Jilin,2,356,354
2024-01-19,PROD013,Beijing,1,1092,1091
2024-01-20,PROD011,Jilin,6,512,506
2024-01-21,PROD015,Shenzhen,1,855,854
2024-01-22,PROD005,Beijing,1,711,710
2024-01-23,PROD013,Shenzhen,1,1225,1224
2024-01-24,PROD013,Guangzhou,6,684,678
2024-01-25,PROD008,Shanghai,10,443,433
2024-01-26,PROD018,Jilin,5,1368,1363
2024-01-27,PROD014,Beijing,6,565,559
2024-01-28,PROD014,Beijing,9,559,550
2024-01-29,PROD017,Shanghai,1,776,775
2024-01-30,PROD019,Shenzhen,3,736,733
2024-01-31,PROD017,Jilin,7,1145,1138
2024-02-01,PROD007,Shenzhen,7,571,564
2024-02-02,PROD020,Beijing,10,1064,1054
2024-02-03,PROD014,Jilin,8,737,729
2024-02-04,PROD018,Guangzhou,6,1044,1038
2024-02-05,PROD020,Jilin,1,1197,1196
2024-02-06,PROD008,Shenzhen,1,748,747
2024-02-07,PROD014,Beijing,9,550,541
2024-02-08,PROD002,Shenzhen,4,1132,1128
2024-02-09,PROD008,Shanghai,9,433,424
2024-02-10,PROD012,Jilin,10,897,887
2024-02-11,PROD019,Jilin,9,887,878
2024-02-12,PROD014,Shanghai,4,637,633
2024-02-13,PROD009,Shenzhen,4,609,605
2024-02-14,PROD014,Jilin,8,729,721
2024-02-15,PROD015,Beijing,7,874,867
2024-02-16,PROD010,Beijing,8,1317,1309
2024-02-17,PROD010,Shenzhen,2,944,942
2024-02-18,PROD016,Guangzhou,2,390,388
2024-02-19,PROD013,Beijing,6,1091,1085
2024-02-20,PROD018,Beijing,6,934,928
2024-02-21,PROD004,Jilin,8,406,398
2024-02-22,PROD002,Shanghai,3,519,516
2024-02-23,PROD014,Shanghai,2,633,631
2024-02-24,PROD013,Beijing,3,1085,1082
2024-02-25,PROD015,Shenzhen,7,854,847
2024-02-26,PROD018,Beijing,10,928,918
2024-02-27,PROD009,Shenzhen,7,605,598
2024-02-28,PROD011,Guangzhou,1,777,776
2024-02-29,PROD002,Shanghai,4,516,512
2024-03-01,PROD009,Beijing,8,545,537
2024-03-02,PROD008,Shanghai,3,424,421
2024-03-03,PROD012,Jilin,5,887,882
2024-03-04,PROD002,Beijing,1,935,934
2024-03-05,PROD014,Beijing,3,541,538
2024-03-06,PROD001,Beijing,3,349,346
2024-03-07,PROD014,Jilin,5,721,716
2024-03-08,PROD011,Shanghai,8,627,619
2024-03-09,PROD003,Shenzhen,1,1006,1005
2024-03-10,PROD013,Jilin,2,862,860
2024-03-11,PROD015,Beijing,6,867,861
2024-03-12,PROD010,Shanghai,7,643,636
2024-03-13,PROD007,Shanghai,7,572,565
2024-03-14,PROD017,Beijing,7,1176,1169
2024-03-15,PROD002,Guangzhou,6,987,981
2024-03-16,PROD017,Beijing,7,1169,1162
2024-03-17,PROD006,Shanghai,4,435,431
2024-03-18,PROD001,Shanghai,1,1004,1003
2024-03-19,PROD017,Jilin,3,1138,1135
2024-03-20,PROD007,Jilin,8,354,346
2024-03-21,PROD014,Guangzhou,6,377,371
2024-03-22,PROD014,Beijing,6,538,532
2024-03-23,PROD002,Shenzhen,6,1128,1122
2024-03-24,PROD003,Beijing,6,1303,1297
2024-03-25,PROD020,Shenzhen,2,1134,1132
2024-03-26,PROD006,Shenzhen,9,429,420
2024-03-27,PROD015,Jilin,8,1060,1052
2024-03-28,PROD020,Jilin,10,1196,1186
2024-03-29,PROD019,Guangzhou,9,1195,1186
2024-03-30,PROD007,Beijing,4,303,299
2024-03-31,PROD008,Shenzhen,2,747,745
2024-04-01,PROD008,Guangzhou,6,1303,1297
2024-04-02,PROD019,Jilin,4,878,874
2024-04-03,PROD007,Guangzhou,7,978,971
2024-04-04,PROD016,Jilin,3,745,742
2024-04-05,PROD008,Shanghai,10,421,411
2024-04-06,PROD005,Jilin,4,785,781
2024-04-07,PROD017,Jilin,5,1135,1130
2024-04-08,PROD016,Beijing,8,1189,1181
2024-04-09,PROD015,Guangzhou,5,738,733
2024-04-10,PROD010,Shanghai,4,636,632
2024-04-11,PROD012,Shenzhen,7,329,322
2024-04-12,PROD012,Shanghai,1,843,842
2024-04-13,PROD007,Shanghai,5,565,560
2024-04-14,PROD003,Shenzhen,4,1005,1001
2024-04-15,PROD013,Shanghai,6,1010,1004
2024-04-16,PROD012,Guangzhou,5,452,447
2024-04-17,PROD016,Beijing,5,1181,1176
2024-04-18,PROD005,Shenzhen,3,634,631
2024-04-19,PROD016,Beijing,8,1176,1168
2024-04-20,PROD001,Jilin,3,496,493
2024-04-21,PROD004,Jilin,8,398,390
2024-04-22,PROD013,Guangzhou,9,678,669
2024-04-23,PROD014,Guangzhou,6,371,365
2024-04-24,PROD017,Shenzhen,10,859,849
2024-04-25,PROD012,Shenzhen,8,322,314
2024-04-26,PROD020,Shenzhen,7,1132,1125
2024-04-27,PROD012,Guangzhou,7,447,440
2024-04-28,PROD010,Beijing,9,1309,1300
2024-04-29,PROD014,Guangzhou,9,365,356
2024-04-30,PROD008,Shanghai,9,411,402
2024-05-01,PROD015,Guangzhou,4,733,729
2024-05-02,PROD005,Jilin,6,781,775
2024-05-03,PROD005,Beijing,7,710,703
2024-05-04,PROD003,Shanghai,5,1109,1104
2024-05-05,PROD015,Beijing,3,861,858
2024-05-06,PROD008,Shenzhen,6,745,739
2024-05-07,PROD006,Shenzhen,5,420,415
2024-05-08,PROD020,Guangzhou,5,562,557
2024-05-09,PROD004,Beijing,1,729,728
2024-05-10,PROD014,Shenzhen,9,674,665
2024-05-11,PROD013,Shanghai,2,1004,1002
2024-05-12,PROD011,Guangzhou,6,776,770
2024-05-13,PROD005,Shanghai,2,814,812
2024-05-14,PROD018,Jilin,8,1363,1355
2024-05-15,PROD004,Shenzhen,2,461,459
2024-05-16,PROD009,Shanghai,5,578,573
2024-05-17,PROD017,Guangzhou,9,437,428
2024-05-18,PROD016,Shenzhen,2,415,413
2024-05-19,PROD013,Beijing,8,1082,1074
2024-05-20,PROD018,Shanghai,10,931,921
2024-05-21,PROD011,Shenzhen,10,933,923
2024-05-22,PROD005,Shenzhen,5,631,626
2024-05-23,PROD019,Guangzhou,8,1186,1178
2024-05-24,PROD018,Shanghai,9,921,912
2024-05-25,PROD004,Guangzhou,4,1266,1262
2024-05-26,PROD005,Jilin,4,775,771
2024-05-27,PROD015,Shanghai,1,443,442
2024-05-28,PROD008,Jilin,5,633,628
2024-05-29,PROD014,Guangzhou,9,356,347
2024-05-30,PROD008,Guangzhou,9,1297,1288
2024-05-31,PROD003,Shenzhen,3,1001,998
2024-06-01,PROD008,Guangzhou,5,1288,1283
2024-06-02,PROD004,Guangzhou,2,1262,1260
2024-06-03,PROD016,Jilin,2,742,740
2024-06-04,PROD002,Shenzhen,9,1122,1113
2024-06-05,PROD016,Shenzhen,7,413,406
2024-06-06,PROD014,Shanghai,10,631,621
2024-06-07,PROD008,Beijing,8,459,451
2024-06-08,PROD003,Jilin,4,1221,1217
2024-06-09,PROD008,Shenzhen,2,739,737
2024-06-10,PROD017,Jilin,6,1130,1124
2024-06-11,PROD007,Jilin,3,346,343
2024-06-12,PROD013,Guangzhou,2,669,667
2024-06-13,PROD008,Guangzhou,5,1283,1278
2024-06-14,PROD016,Beijing,1,1168,1167
2024-06-15,PROD003,Shenzhen,9,998,989
2024-06-16,PROD020,Shanghai,3,451,448
2024-06-17,PROD007,Shenzhen,5,564,559
2024-06-18,PROD019,Beijing,6,654,648
2024-06-19,PROD006,Guangzhou,7,1195,1188
2024-06-20,PROD020,Guangzhou,9,557,548
2024-06-21,PROD018,Guangzhou,5,1038,1033
2024-06-22,PROD008,Shenzhen,8,737,729
2024-06-23,PROD014,Beijing,1,532,531
2024-06-24,PROD020,Shanghai,6,448,442
2024-06-25,PROD011,Jilin,7,506,499
2024-06-26,PROD009,Shanghai,3,573,570
2024-06-27,PROD001,Shenzhen,7,637,630
2024-06-28,PROD013,Guangzhou,5,667,662
2024-06-29,PROD009,Jilin,10,420,410
2024-06-30,PROD001,Shanghai,4,1003,999
2024-07-01,PROD007,Beijing,7,299,292
2024-07-02,PROD013,Jilin,2,860,858
2024-07-03,PROD006,Shanghai,3,431,428
2024-07-04,PROD006,Jilin,10,869,859
2024-07-05,PROD002,Guangzhou,6,981,975
2024-07-06,PROD011,Shenzhen,2,923,921
2024-07-07,PROD011,Shanghai,10,619,609
2024-07-08,PROD020,Shanghai,3,442,439
2024-07-09,PROD005,Jilin,8,771,763
2024-07-10,PROD020,Jilin,4,1186,1182
2024-07-11,PROD014,Jilin,1,716,715
2024-07-12,PROD009,Guangzhou,2,1181,1179
2024-07-13,PROD018,Beijing,4,918,914
2024-07-14,PROD003,Jilin,4,1217,1213
2024-07-15,PROD015,Jilin,3,1052,1049
2024-07-16,PROD012,Shanghai,4,842,838
2024-07-17,PROD015,Shenzhen,8,847,839
2024-07-18,PROD018,Jilin,7,1355,1348
2024-07-19,PROD008,Guangzhou,10,1278,1268
2024-07-20,PROD006,Guangzhou,4,1188,1184
2024-07-21,PROD008,Shanghai,1,402,401
2024-07-22,PROD009,Guangzhou,3,1179,1176
2024-07-23,PROD019,Beijing,5,648,643
2024-07-24,PROD009,Guangzhou,5,1176,1171
2024-07-25,PROD014,Beijing,7,531,524
2024-07-26,PROD017,Shanghai,8,775,767
2024-07-27,PROD008,Guangzhou,7,1268,1261
2024-07-28,PROD012,Shenzhen,10,314,304
2024-07-29,PROD011,Jilin,2,499,497
2024-07-30,PROD011,Beijing,8,1365,1357
2024-07-31,PROD004,Jilin,7,390,383
2024-08-01,PROD016,Guangzhou,6,388,382
2024-08-02,PROD020,Jilin,1,1182,1181
2024-08-03,PROD014,Shanghai,9,621,612
2024-08-04,PROD006,Beijing,3,902,899
2024-08-05,PROD014,Shenzhen,8,665,657
2024-08-06,PROD009,Shanghai,1,570,569
2024-08-07,PROD020,Jilin,5,1181,1176
2024-08-08,PROD016,Jilin,5,740,735
2024-08-09,PROD012,Shanghai,10,838,828
2024-08-10,PROD012,Beijing,10,1110,1100
2024-08-11,PROD013,Guangzhou,8,662,654
2024-08-12,PROD014,Shanghai,5,612,607
2024-08-13,PROD004,Jilin,7,383,376
2024-08-14,PROD011,Beijing,7,1357,1350
2024-08-15,PROD009,Jilin,9,410,401
2024-08-16,PROD012,Shenzhen,2,304,302
2024-08-17,PROD007,Guangzhou,9,971,962
2024-08-18,PROD005,Jilin,4,763,759
2024-08-19,PROD007,Beijing,5,292,287
2024-08-20,PROD013,Guangzhou,5,654,649
2024-08-21,PROD012,Beijing,8,1100,1092
2024-08-22,PROD016,Guangzhou,8,382,374
2024-08-23,PROD019,Shenzhen,9,733,724
2024-08-24,PROD008,Shanghai,4,401,397
2024-08-25,PROD009,Shanghai,10,569,559
2024-08-26,PROD017,Guangzhou,6,428,422
2024-08-27,PROD011,Beijing,6,1350,1344
2024-08-28,PROD003,Shanghai,10,1104,1094
2024-08-29,PROD012,Shenzhen,1,302,301
2024-08-30,PROD010,Shanghai,1,632,631
2024-08-31,PROD011,Beijing,5,1344,1339
2024-09-01,PROD014,Jilin,8,715,707
2024-09-02,PROD007,Beijing,10,287,277
2024-09-03,PROD018,Shenzhen,1,1098,1097
2024-09-04,PROD020,Guangzhou,4,548,544
2024-09-05,PROD017,Shenzhen,9,849,840
2024-09-06,PROD019,Guangzhou,7,1178,1171
2024-09-07,PROD013,Guangzhou,9,649,640
2024-09-08,PROD002,Jilin,9,926,917
2024-09-09,PROD020,Shanghai,4,439,435
2024-09-10,PROD015,Shenzhen,6,839,833
2024-09-11,PROD015,Guangzhou,5,729,724
2024-09-12,PROD015,Shanghai,3,442,439
2024-09-13,PROD002,Jilin,9,917,908
2024-09-14,PROD017,Shenzhen,10,840,830
2024-09-15,PROD003,Shanghai,2,1094,1092
2024-09-16,PROD007,Shenzhen,8,559,551
2024-09-17,PROD016,Shanghai,9,1162,1153
2024-09-18,PROD008,Beijing,4,451,447
2024-09-19,PROD019,Beijing,7,643,636
2024-09-20,PROD011,Jilin,10,497,487
2024-09-21,PROD010,Beijing,2,1300,1298
2024-09-22,PROD016,Jilin,8,735,727
2024-09-23,PROD008,Beijing,8,447,439
2024-09-24,PROD018,Shanghai,6,912,906
2024-09-25,PROD020,Beijing,5,1054,1049
2024-09-26,PROD003,Beijing,6,1297,1291
2024-09-27,PROD007,Shanghai,5,560,555
2024-09-28,PROD017,Shenzhen,7,830,823
2024-09-29,PROD011,Jilin,8,487,479
2024-09-30,PROD018,Guangzhou,2,1033,1031
2024-10-01,PROD011,Jilin,5,479,474
2024-10-02,PROD015,Shanghai,4,439,435
2024-10-03,PROD002,Shenzhen,8,1113,1105
2024-10-04,PROD016,Beijing,10,1167,1157
2024-10-05,PROD013,Guangzhou,3,640,637
2024-10-06,PROD003,Shenzhen,10,989,979
2024-10-07,PROD005,Shanghai,4,812,808
2024-10-08,PROD020,Guangzhou,8,544,536
2024-10-09,PROD019,Guangzhou,1,1171,1170
2024-10-10,PROD002,Shenzhen,1,1105,1104
2024-10-11,PROD017,Guangzhou,5,422,417
2024-10-12,PROD004,Guangzhou,5,1260,1255
2024-10-13,PROD006,Beijing,4,899,895
2024-10-14,PROD002,Jilin,4,908,904
2024-10-15,PROD020,Shanghai,5,435,430
2024-10-16,PROD012,Jilin,9,882,873
2024-10-17,PROD001,Shanghai,1,999,998
2024-10-18,PROD016,Beijing,1,1157,1156
2024-10-19,PROD015,Shanghai,8,435,427
2024-10-20,PROD019,Guangzhou,4,1170,1166
2024-10-21,PROD011,Shenzhen,8,921,913
2024-10-22,PROD005,Shenzhen,5,626,621
2024-10-23,PROD019,Guangzhou,8,1166,1158
2024-10-24,PROD019,Jilin,4,874,870
2024-10-25,PROD016,Beijing,1,1156,1155
2024-10-26,PROD003,Shenzhen,9,979,970
2024-10-27,PROD012,Guangzhou,4,440,436
2024-10-28,PROD015,Shenzhen,9,833,824
2024-10-29,PROD008,Jilin,2,628,626
2024-10-30,PROD019,Shanghai,6,1051,1045
2024-10-31,PROD015,Shanghai,9,427,418
2024-11-01,PROD002,Shenzhen,5,1104,1099
2024-11-02,PROD017,Jilin,7,1124,1117
2024-11-03,PROD011,Shanghai,8,609,601
2024-11-04,PROD008,Guangzhou,7,1261,1254
2024-11-05,PROD012,Guangzhou,2,436,434
2024-11-06,PROD001,Shenzhen,7,630,623
2024-11-07,PROD006,Jilin,8,859,851
2024-11-08,PROD007,Shenzhen,10,551,541
2024-11-09,PROD011,Jilin,10,474,464
2024-11-10,PROD016,Beijing,6,1155,1149
2024-11-11,PROD001,Jilin,4,493,489
2024-11-12,PROD015,Guangzhou,2,724,722
2024-11-13,PROD002,Beijing,10,934,924
2024-11-14,PROD009,Guangzhou,7,1171,1164
2024-11-15,PROD016,Shanghai,7,1153,1146
2024-11-16,PROD002,Jilin,5,904,899
2024-11-17,PROD013,Shenzhen,10,1224,1214
2024-11-18,PROD014,Shanghai,9,607,598
2024-11-19,PROD009,Beijing,2,537,535
2024-11-20,PROD002,Beijing,5,924,919
2024-11-21,PROD018,Jilin,6,1348,1342
2024-11-22,PROD012,Beijing,2,1092,1090
2024-11-23,PROD001,Shenzhen,4,623,619
2024-11-24,PROD015,Guangzhou,6,722,716
2024-11-25,PROD002,Beijing,5,919,914
2024-11-26,PROD005,Beijing,6,703,697
2024-11-27,PROD018,Jilin,7,1342,1335
2024-11-28,PROD007,Guangzhou,3,962,959
2024-11-29,PROD010,Shanghai,7,631,624
2024-11-30,PROD012,Shenzhen,3,301,298
2024-12-01,PROD010,Jilin,4,446,442
2024-12-02,PROD016,Beijing,4,1149,1145
2024-12-03,PROD018,Shanghai,3,906,903
2024-12-04,PROD011,Jilin,9,464,455
2024-12-05,PROD015,Guangzhou,5,716,711
2024-12-06,PROD006,Shenzhen,9,415,406
2024-12-07,PROD013,Beijing,3,1074,1071
2024-12-08,PROD010,Beijing,5,1298,1293
2024-12-09,PROD007,Jilin,2,343,341
2024-12-10,PROD005,Beijing,6,697,691
2024-12-11,PROD015,Shenzhen,3,824,821
2024-12-12,PROD019,Shenzhen,6,724,718
2024-12-13,PROD014,Shenzhen,5,657,652
2024-12-14,PROD001,Beijing,10,346,336
2024-12-15,PROD004,Shanghai,1,1276,1275
2024-12-16,PROD010,Jilin,7,442,435
2024-12-17,PROD011,Jilin,1,455,454
2024-12-18,PROD020,Beijing,8,1049,1041
2024-12-19,PROD016,Jilin,10,727,717
2024-12-20,PROD003,Shanghai,3,1092,1089
2024-12-21,PROD010,Shanghai,6,624,618
2024-12-22,PROD017,Jilin,1,1117,1116
2024-12-23,PROD012,Beijing,4,1090,1086
2024-12-24,PROD013,Jilin,3,858,855
2024-12-25,PROD019,Shenzhen,5,718,713
2024-12-26,PROD004,Shanghai,8,1275,1267
2024-12-27,PROD006,Shanghai,6,428,422
2024-12-28,PROD005,Guangzhou,4,500,496
2024-12-29,PROD008,Shanghai,1,397,396
2024-12-30,PROD014,Shenzhen,6,652,646
2024-01-01,PROD017,Shanghai,2,767,765
2024-01-02,PROD012,Jilin,8,873,865
2024-01-03,PROD002,Guangzhou,8,975,967
2024-01-04,PROD006,Shenzhen,10,406,396
2024-01-05,PROD017,Guangzhou,1,417,416
2024-01-06,PROD009,Guangzhou,3,1164,1161
2024-01-07,PROD011,Guangzhou,5,770,765
2024-01-08,PROD003,Beijing,1,1291,1290
2024-01-09,PROD013,Jilin,6,855,849
2024-01-10,PROD008,Shanghai,6,396,390
2024-01-11,PROD001,Beijing,2,336,334
2024-01-12,PROD008,Shenzhen,8,729,721
2024-01-13,PROD009,Shanghai,5,559,554
2024-01-14,PROD012,Guangzhou,10,434,424
2024-01-15,PROD006,Beijing,5,895,890
2024-01-16,PROD005,Jilin,3,759,756
2024-01-17,PROD007,Shenzhen,3,541,538
2024-01-18,PROD017,Beijing,4,1162,1158
2024-01-19,PROD020,Beijing,8,1041,1033
2024-01-20,PROD010,Shenzhen,6,942,936
2024-01-21,PROD006,Shanghai,8,422,414
2024-01-22,PROD017,Guangzhou,7,416,409
2024-01-23,PROD016,Beijing,10,1145,1135
2024-01-24,PROD007,Jilin,3,341,338
2024-01-25,PROD020,Beijing,1,1033,1032
2024-01-26,PROD014,Shanghai,8,598,590
2024-01-27,PROD012,Guangzhou,2,424,422
2024-01-28,PROD014,Jilin,3,707,704
2024-01-29,PROD016,Jilin,4,717,713
2024-01-30,PROD002,Guangzhou,2,967,965
2024-01-31,PROD019,Beijing,1,636,635
2024-02-01,PROD003,Shenzhen,5,970,965
2024-02-02,PROD017,Beijing,5,1158,1153
2024-02-03,PROD015,Guangzhou,5,711,706
2024-02-04,PROD018,Shanghai,10,903,893
2024-02-05,PROD002,Jilin,3,899,896
2024-02-06,PROD015,Shenzhen,7,821,814
2024-02-07,PROD020,Shanghai,10,430,420
2024-02-08,PROD019,Jilin,4,870,866
2024-02-09,PROD020,Jilin,7,1176,1169
2024-02-10,PROD011,Shenzhen,3,913,910
2024-02-11,PROD018,Guangzhou,4,1031,1027
2024-02-12,PROD013,Shanghai,3,1002,999
2024-02-13,PROD012,Jilin,4,865,861
2024-02-14,PROD017,Shenzhen,5,823,818
2024-02-15,PROD015,Shanghai,3,418,415
2024-02-16,PROD010,Shenzhen,5,936,931
2024-02-17,PROD015,Shanghai,6,415,409
2024-02-18,PROD017,Jilin,2,1116,1114
2024-02-19,PROD003,Shenzhen,3,965,962
2024-02-20,PROD015,Shanghai,2,409,407
2024-02-21,PROD020,Guangzhou,4,536,532
2024-02-22,PROD008,Jilin,9,626,617
2024-02-23,PROD013,Beijing,8,1071,1063
2024-02-24,PROD017,Shenzhen,5,818,813
2024-02-25,PROD012,Beijing,7,1086,1079
2024-02-26,PROD015,Shenzhen,6,814,808
2024-02-27,PROD020,Shenzhen,1,1125,1124
2024-02-28,PROD016,Shanghai,7,1146,1139
2024-02-29,PROD004,Guangzhou,1,1255,1254
2024-03-01,PROD005,Beijing,6,691,685
2024-03-02,PROD014,Jilin,8,704,696
2024-03-03,PROD015,Shanghai,3,407,404
2024-03-04,PROD005,Shanghai,5,808,803
2024-03-05,PROD012,Jilin,9,861,852
2024-03-06,PROD008,Guangzhou,6,1254,1248
2024-03-07,PROD001,Shenzhen,6,619,613
2024-03-08,PROD014,Shenzhen,2,646,644
2024-03-09,PROD003,Guangzhou,5,1033,1028
2024-03-10,PROD008,Shenzhen,9,721,712
2024-03-11,PROD012,Shenzhen,2,298,296
2024-03-12,PROD007,Guangzhou,5,959,954
2024-03-13,PROD009,Jilin,4,401,397
2024-03-14,PROD016,Guangzhou,2,374,372
2024-03-15,PROD007,Guangzhou,2,954,952
2024-03-16,PROD018,Guangzhou,9,1027,1018
2024-03-17,PROD019,Shenzhen,4,713,709
2024-03-18,PROD001,Shenzhen,3,613,610
2024-03-19,PROD017,Shenzhen,3,813,810
2024-03-20,PROD012,Guangzhou,10,422,412
2024-03-21,PROD005,Shenzhen,4,621,617
2024-03-22,PROD020,Guangzhou,9,532,523
2024-03-23,PROD019,Shanghai,10,1045,1035
2024-03-24,PROD009,Beijing,9,535,526
2024-03-25,PROD002,Beijing,2,914,912
2024-03-26,PROD010,Shenzhen,2,931,929
2024-03-27,PROD010,Jilin,10,435,425
2024-03-28,PROD013,Shanghai,2,999,997
2024-03-29,PROD008,Shanghai,2,390,388
2024-03-30,PROD014,Shanghai,5,590,585
2024-03-31,PROD007,Beijing,5,277,272
2024-04-01,PROD012,Jilin,4,852,848
2024-04-02,PROD015,Guangzhou,2,706,704
2024-04-03,PROD006,Beijing,1,890,889
2024-04-04,PROD003,Jilin,4,1213,1209
2024-04-05,PROD007,Shanghai,8,555,547
2024-04-06,PROD015,Guangzhou,2,704,702
2024-04-07,PROD002,Jilin,7,896,889
2024-04-08,PROD005,Jilin,1,756,755
2024-04-09,PROD020,Jilin,8,1169,1161
2024-04-10,PROD003,Guangzhou,9,1028,1019
2024-04-11,PROD007,Beijing,2,272,270
2024-04-12,PROD016,Shenzhen,1,406,405
2024-04-13,PROD002,Jilin,2,889,887
2024-04-14,PROD002,Guangzhou,3,965,962
2024-04-15,PROD002,Shanghai,8,512,504
2024-04-16,PROD017,Shanghai,8,765,757
2024-04-17,PROD014,Shanghai,2,585,583
2024-04-18,PROD001,Shenzhen,2,610,608
2024-04-19,PROD004,Jilin,10,376,366
2024-04-20,PROD017,Guangzhou,1,409,408
2024-04-21,PROD003,Shanghai,9,1089,1080
2024-04-22,PROD001,Jilin,9,489,480
2024-04-23,PROD016,Shenzhen,9,405,396
2024-04-24,PROD007,Shanghai,5,547,542
2024-04-25,PROD010,Shenzhen,7,929,922
2024-04-26,PROD004,Jilin,10,366,356
2024-04-27,PROD007,Shanghai,1,542,541
2024-04-28,PROD004,Jilin,10,356,346
2024-04-29,PROD019,Jilin,10,866,856
2024-04-30,PROD009,Beijing,8,526,518
2024-05-01,PROD002,Guangzhou,8,962,954
2024-05-02,PROD009,Jilin,7,397,390
2024-05-03,PROD006,Shenzhen,6,396,390
2024-05-04,PROD002,Shenzhen,1,1099,1098
2024-05-05,PROD015,Beijing,6,858,852
2024-05-06,PROD001,Shenzhen,3,608,605
2024-05-07,PROD006,Shanghai,1,414,413
2024-05-08,PROD016,Beijing,6,1135,1129
2024-05-09,PROD007,Guangzhou,4,952,948
2024-05-10,PROD004,Shanghai,5,1267,1262
2024-05-11,PROD004,Shenzhen,7,459,452
2024-05-12,PROD019,Beijing,2,635,633
2024-05-13,PROD006,Guangzhou,5,1184,1179
2024-05-14,PROD006,Jilin,6,851,845
2024-05-15,PROD009,Beijing,7,518,511
2024-05-16,PROD009,Guangzhou,8,1161,1153
2024-05-17,PROD002,Shanghai,1,504,503
2024-05-18,PROD010,Shenzhen,9,922,913
2024-05-19,PROD001,Beijing,4,334,330
2024-05-20,PROD016,Shanghai,8,1139,1131
2024-05-21,PROD010,Beijing,4,1293,1289
2024-05-22,PROD017,Beijing,5,1153,1148
2024-05-23,PROD017,Beijing,3,1148,1145
2024-05-24,PROD015,Guangzhou,5,702,697
2024-05-25,PROD010,Jilin,10,425,415
2024-05-26,PROD006,Shanghai,4,413,409
2024-05-27,PROD019,Guangzhou,4,1158,1154
2024-05-28,PROD019,Shenzhen,5,709,704
2024-05-29,PROD008,Shanghai,9,388,379
2024-05-30,PROD015,Shanghai,1,404,403
2024-05-31,PROD011,Jilin,6,454,448
2024-06-01,PROD014,Shanghai,2,583,581
2024-06-02,PROD003,Beijing,5,1290,1285
2024-06-03,PROD013,Shenzhen,8,1214,1206
2024-06-04,PROD018,Guangzhou,9,1018,1009
2024-06-05,PROD015,Beijing,8,852,844
2024-06-06,PROD016,Guangzhou,7,372,365
2024-06-07,PROD003,Shanghai,3,1080,1077
2024-06-08,PROD012,Guangzhou,8,412,404
2024-06-09,PROD005,Beijing,7,685,678
2024-06-10,PROD010,Shenzhen,3,913,910
2024-06-11,PROD004,Jilin,6,346,340
2024-06-12,PROD008,Shanghai,3,379,376
2024-06-13,PROD007,Jilin,6,338,332
2024-06-14,PROD007,Guangzhou,3,948,945
2024-06-15,PROD020,Guangzhou,8,523,515
2024-06-16,PROD011,Shenzhen,5,910,905
2024-06-17,PROD001,Guangzhou,10,1142,1132
2024-06-18,PROD019,Beijing,3,633,630
2024-06-19,PROD009,Shanghai,10,554,544
2024-06-20,PROD018,Guangzhou,9,1009,1000
2024-06-21,PROD016,Shanghai,9,1131,1122
2024-06-22,PROD013,Shenzhen,6,1206,1200
2024-06-23,PROD015,Jilin,1,1049,1048
2024-06-24,PROD004,Jilin,10,340,330
2024-06-25,PROD016,Shanghai,3,1122,1119
2024-06-26,PROD013,Shenzhen,3,1200,1197
2024-06-27,PROD010,Guangzhou,6,1290,1284
2024-06-28,PROD004,Beijing,1,728,727
2024-06-29,PROD015,Shanghai,1,403,402
2024-06-30,PROD006,Beijing,8,889,881
2024-07-01,PROD017,Shanghai,5,757,752
2024-07-02,PROD019,Beijing,8,630,622
2024-07-03,PROD011,Jilin,2,448,446
2024-07-04,PROD012,Shenzhen,10,296,286
2024-07-05,PROD020,Shenzhen,7,1124,1117
2024-07-06,PROD003,Shanghai,2,1077,1075
2024-07-07,PROD016,Guangzhou,7,365,358
2024-07-08,PROD006,Jilin,6,845,839
2024-07-09,PROD006,Beijing,6,881,875
2024-07-10,PROD003,Guangzhou,3,1019,1016
2024-07-11,PROD017,Guangzhou,4,408,404
2024-07-12,PROD016,Guangzhou,3,358,355
2024-07-13,PROD015,Jilin,8,1048,1040
2024-07-14,PROD010,Shenzhen,6,910,904
2024-07-15,PROD014,Shenzhen,5,644,639
2024-07-16,PROD013,Jilin,2,849,847
2024-07-17,PROD013,Shenzhen,4,1197,1193
2024-07-18,PROD002,Shenzhen,2,1098,1096
2024-07-19,PROD003,Jilin,4,1209,1205
2024-07-20,PROD015,Shenzhen,4,808,804
2024-07-21,PROD018,Beijing,10,914,904
2024-07-22,PROD014,Shenzhen,10,639,629
2024-07-23,PROD016,Jilin,2,713,711
2024-07-24,PROD006,Guangzhou,10,1179,1169
2024-07-25,PROD013,Jilin,5,847,842
2024-07-26,PROD011,Guangzhou,9,765,756
2024-07-27,PROD006,Beijing,9,875,866
2024-07-28,PROD017,Shanghai,4,752,748
2024-07-29,PROD013,Guangzhou,8,637,629
2024-07-30,PROD006,Shenzhen,7,390,383
2024-07-31,PROD006,Jilin,4,839,835
2024-08-01,PROD013,Guangzhou,10,629,619
2024-08-02,PROD011,Shanghai,7,601,594
2024-08-03,PROD019,Beijing,6,622,616
2024-08-04,PROD009,Shenzhen,3,598,595
2024-08-05,PROD006,Jilin,2,835,833
2024-08-06,PROD006,Beijing,5,866,861
2024-08-07,PROD006,Shanghai,10,409,399
2024-08-08,PROD004,Shenzhen,9,452,443
2024-08-09,PROD014,Jilin,5,696,691
2024-08-10,PROD002,Jilin,2,887,885
2024-08-11,PROD014,Guangzhou,5,347,342
2024-08-12,PROD008,Shanghai,1,376,375
2024-08-13,PROD010,Beijing,5,1289,1284
2024-08-14,PROD019,Beijing,2,616,614
2024-08-15,PROD005,Shanghai,9,803,794
2024-08-16,PROD012,Guangzhou,4,404,400
2024-08-17,PROD016,Guangzhou,2,355,353
2024-08-18,PROD007,Shanghai,1,541,540
2024-08-19,PROD019,Shanghai,2,1035,1033
2024-08-20,PROD005,Shanghai,9,794,785
2024-08-21,PROD020,Shenzhen,7,1117,1110
2024-08-22,PROD017,Guangzhou,5,404,399
2024-08-23,PROD017,Jilin,6,1114,1108
2024-08-24,PROD004,Beijing,2,727,725
2024-08-25,PROD015,Guangzhou,3,697,694
2024-08-26,PROD020,Guangzhou,2,515,513
2024-08-27,PROD012,Beijing,7,1079,1072
2024-08-28,PROD001,Shenzhen,5,605,600
2024-08-29,PROD001,Beijing,3,330,327
2024-08-30,PROD012,Shenzhen,7,286,279
2024-08-31,PROD003,Guangzhou,6,1016,1010
2024-09-01,PROD019,Shenzhen,9,704,695
2024-09-02,PROD008,Guangzhou,7,1248,1241
2024-09-03,PROD001,Guangzhou,7,1132,1125
2024-09-04,PROD020,Jilin,5,1161,1156
2024-09-05,PROD010,Guangzhou,5,1284,1279
2024-09-06,PROD012,Jilin,7,848,841
2024-09-07,PROD005,Shanghai,4,785,781
2024-09-08,PROD015,Shanghai,1,402,401
2024-09-09,PROD003,Beijing,9,1285,1276
2024-09-10,PROD010,Guangzhou,2,1279,1277
2024-09-11,PROD011,Beijing,5,1339,1334
2024-09-12,PROD004,Jilin,6,330,324
2024-09-13,PROD009,Shanghai,5,544,539
2024-09-14,PROD018,Jilin,6,1335,1329
2024-09-15,PROD009,Beijing,5,511,506
2024-09-16,PROD020,Shenzhen,2,1110,1108
2024-09-17,PROD007,Shenzhen,9,538,529
2024-09-18,PROD011,Shanghai,8,594,586
2024-09-19,PROD018,Guangzhou,10,1000,990
2024-09-20,PROD012,Guangzhou,1,400,399
2024-09-21,PROD018,Beijing,1,904,903
2024-09-22,PROD020,Guangzhou,1,513,512
2024-09-23,PROD009,Shenzhen,7,595,588
2024-09-24,PROD006,Shanghai,7,399,392
2024-09-25,PROD018,Beijing,3,903,900
2024-09-26,PROD006,Shanghai,10,392,382
2024-09-27,PROD004,Beijing,1,725,724
2024-09-28,PROD010,Guangzhou,3,1277,1274
2024-09-29,PROD007,Shenzhen,2,529,527
2024-09-30,PROD019,Jilin,4,856,852
2024-10-01,PROD017,Shenzhen,6,810,804
2024-10-02,PROD008,Guangzhou,7,1241,1234
2024-10-03,PROD003,Shanghai,4,1075,1071
2024-10-04,PROD020,Jilin,7,1156,1149
2024-10-05,PROD008,Beijing,10,439,429
2024-10-06,PROD014,Jilin,9,691,682
2024-10-07,PROD018,Guangzhou,7,990,983
2024-10-08,PROD012,Beijing,10,1072,1062
2024-10-09,PROD015,Shenzhen,3,804,801
2024-10-10,PROD018,Beijing,5,900,895
2024-10-11,PROD012,Shanghai,3,828,825
2024-10-12,PROD004,Beijing,7,724,717
2024-10-13,PROD019,Shanghai,8,1033,1025
2024-10-14,PROD008,Jilin,5,617,612
2024-10-15,PROD012,Beijing,1,1062,1061
2024-10-16,PROD017,Jilin,6,1108,1102
2024-10-17,PROD007,Jilin,1,332,331
2024-10-18,PROD008,Shanghai,8,375,367
2024-10-19,PROD009,Beijing,6,506,500
2024-10-20,PROD006,Beijing,9,861,852
2024-10-21,PROD017,Shenzhen,10,804,794
2024-10-22,PROD010,Guangzhou,7,1274,1267
2024-10-23,PROD018,Guangzhou,4,983,979
2024-10-24,PROD010,Guangzhou,4,1267,1263
2024-10-25,PROD020,Shenzhen,9,1108,1099
2024-10-26,PROD014,Shenzhen,9,629,620
2024-10-27,PROD017,Guangzhou,1,399,398
2024-10-28,PROD018,Shenzhen,9,1097,1088
2024-10-29,PROD001,Beijing,10,327,317
2024-10-30,PROD020,Guangzhou,1,512,511
2024-10-31,PROD005,Shenzhen,10,617,607
2024-11-01,PROD003,Shanghai,10,1071,1061
2024-11-02,PROD015,Beijing,8,844,836
2024-11-03,PROD002,Shenzhen,2,1096,1094
2024-11-04,PROD010,Jilin,4,415,411
2024-11-05,PROD010,Jilin,9,411,402
2024-11-06,PROD011,Shanghai,7,586,579
2024-11-07,PROD019,Guangzhou,3,1154,1151
2024-11-08,PROD014,Shanghai,7,581,574
2024-11-09,PROD009,Guangzhou,6,1153,1147
2024-11-10,PROD003,Jilin,2,1205,1203
2024-11-11,PROD013,Shenzhen,7,1193,1186
2024-11-12,PROD018,Jilin,2,1329,1327
2024-11-13,PROD007,Beijing,5,270,265
2024-11-14,PROD001,Beijing,9,317,308
2024-11-15,PROD017,Shanghai,8,748,740
2024-11-16,PROD002,Guangzhou,3,954,951
2024-11-17,PROD005,Shenzhen,8,607,599
2024-11-18,PROD010,Shenzhen,9,904,895
2024-11-19,PROD014,Beijing,6,524,518
2024-11-20,PROD017,Guangzhou,2,398,396
2024-11-21,PROD018,Guangzhou,3,979,976
2024-11-22,PROD001,Shenzhen,6,600,594
2024-11-23,PROD013,Beijing,3,1063,1060
2024-11-24,PROD006,Jilin,5,833,828
2024-11-25,PROD013,Shanghai,1,997,996
2024-11-26,PROD015,Shenzhen,7,801,794
2024-11-27,PROD011,Shanghai,9,579,570
2024-11-28,PROD003,Shenzhen,6,962,956
2024-11-29,PROD017,Guangzhou,6,396,390
2024-11-30,PROD001,Shanghai,8,998,990
2024-12-01,PROD007,Jilin,6,331,325
2024-12-02,PROD002,Beijing,4,912,908
2024-12-03,PROD005,Guangzhou,5,496,491
2024-12-04,PROD006,Shenzhen,7,383,376
2024-12-05,PROD007,Jilin,6,325,319
2024-12-06,PROD010,Jilin,7,402,395
2024-12-07,PROD006,Shanghai,8,382,374
2024-12-08,PROD013,Shenzhen,6,1186,1180
2024-12-09,PROD016,Beijing,7,1129,1122
2024-12-10,PROD015,Jilin,1,1040,1039
2024-12-11,PROD017,Jilin,8,1102,1094
2024-12-12,PROD012,Shanghai,1,825,824
2024-12-13,PROD014,Shenzhen,9,620,611
2024-12-14,PROD018,Guangzhou,7,976,969
2024-12-15,PROD017,Guangzhou,4,390,386
2024-12-16,PROD011,Guangzhou,8,756,748
2024-12-17,PROD020,Guangzhou,6,511,505
2024-12-18,PROD006,Jilin,6,828,822
2024-12-19,PROD012,Shenzhen,3,279,276
2024-12-20,PROD016,Shenzhen,4,396,392
2024-12-21,PROD012,Jilin,8,841,833
2024-12-22,PROD015,Shanghai,4,401,397
2024-12-23,PROD020,Beijing,4,1032,1028
2024-12-24,PROD002,Shenzhen,3,1094,1091
2024-12-25,PROD016,Shenzhen,3,392,389
2024-12-26,PROD002,Shanghai,6,503,497
2024-12-27,PROD013,Shenzhen,7,1180,1173
2024-12-28,PROD005,Guangzhou,2,491,489
2024-12-29,PROD013,Guangzhou,6,619,613
2024-12-30,PROD005,Shanghai,7,781,774
2024-01-01,PROD008,Guangzhou,3,1234,1231
2024-01-02,PROD008,Shanghai,3,367,364
2024-01-03,PROD004,Beijing,10,717,707
2024-01-04,PROD013,Shanghai,10,996,986
2024-01-05,PROD001,Jilin,7,480,473
2024-01-06,PROD007,Shenzhen,5,527,522
2024-01-07,PROD005,Shanghai,7,774,767
2024-01-08,PROD020,Guangzhou,9,505,496
2024-01-09,PROD018,Beijing,4,895,891
2024-01-10,PROD010,Shenzhen,6,895,889
2024-01-11,PROD011,Guangzhou,3,748,745
2024-01-12,PROD009,Jilin,7,390,383
2024-01-13,PROD011,Guangzhou,9,745,736
2024-01-14,PROD016,Shenzhen,6,389,383
2024-01-15,PROD016,Beijing,10,1122,1112
2024-01-16,PROD002,Shenzhen,2,1091,1089
2024-01-17,PROD005,Guangzhou,1,489,488
2024-01-18,PROD019,Beijing,8,614,606
2024-01-19,PROD005,Beijing,8,678,670
2024-01-20,PROD013,Shanghai,7,986,979
2024-01-21,PROD020,Shanghai,8,420,412
2024-01-22,PROD011,Guangzhou,3,736,733
2024-01-23,PROD018,Beijing,7,891,884
2024-01-24,PROD001,Shanghai,7,990,983
2024-01-25,PROD001,Shenzhen,8,594,586
2024-01-26,PROD011,Guangzhou,9,733,724
2024-01-27,PROD008,Jilin,4,612,608
2024-01-28,PROD010,Shanghai,9,618,609
2024-01-29,PROD010,Shenzhen,6,889,883
2024-01-30,PROD018,Shenzhen,1,1088,1087
2024-01-31,PROD005,Jilin,7,755,748
2024-02-01,PROD005,Shanghai,4,767,763
2024-02-02,PROD001,Guangzhou,6,1125,1119
2024-02-03,PROD009,Beijing,10,500,490
2024-02-04,PROD011,Jilin,1,446,445
2024-02-05,PROD015,Guangzhou,10,694,684
2024-02-06,PROD012,Jilin,2,833,831
2024-02-07,PROD015,Jilin,3,1039,1036
2024-02-08,PROD017,Jilin,6,1094,1088
2024-02-09,PROD004,Shanghai,7,1262,1255
2024-02-10,PROD010,Guangzhou,5,1263,1258
2024-02-11,PROD015,Jilin,1,1036,1035
2024-02-12,PROD010,Beijing,4,1284,1280
2024-02-13,PROD008,Beijing,3,429,426
2024-02-14,PROD004,Shanghai,9,1255,1246
2024-02-15,PROD016,Beijing,6,1112,1106
2024-02-16,PROD002,Beijing,9,908,899
2024-02-17,PROD007,Beijing,4,265,261
2024-02-18,PROD013,Beijing,10,1060,1050
2024-02-19,PROD003,Shenzhen,8,956,948
2024-02-20,PROD018,Beijing,8,884,876
2024-02-21,PROD002,Jilin,1,885,884
2024-02-22,PROD013,Guangzhou,4,613,609
2024-02-23,PROD005,Shanghai,5,763,758
2024-02-24,PROD001,Beijing,8,308,300
2024-02-25,PROD018,Jilin,6,1327,1321
2024-02-26,PROD007,Beijing,8,261,253
2024-02-27,PROD017,Beijing,1,1145,1144
2024-02-28,PROD013,Beijing,3,1050,1047
2024-02-29,PROD019,Shenzhen,1,695,694
2024-03-01,PROD011,Beijing,2,1334,1332
2024-03-02,PROD005,Shanghai,9,758,749
2024-03-03,PROD016,Jilin,4,711,707
2024-03-04,PROD006,Shenzhen,2,376,374
2024-03-05,PROD010,Beijing,8,1280,1272
2024-03-06,PROD019,Jilin,5,852,847
2024-03-07,PROD009,Guangzhou,6,1147,1141
2024-03-08,PROD011,Jilin,4,445,441
2024-03-09,PROD019,Shanghai,1,1025,1024
2024-03-10,PROD005,Guangzhou,3,488,485
2024-03-11,PROD020,Beijing,2,1028,1026
2024-03-12,PROD019,Shenzhen,6,694,688
2024-03-13,PROD011,Guangzhou,4,724,720
2024-03-14,PROD007,Jilin,9,319,310
2024-03-15,PROD011,Beijing,9,1332,1323
2024-03-16,PROD010,Shanghai,8,609,601
2024-03-17,PROD019,Shanghai,9,1024,1015
2024-03-18,PROD003,Shenzhen,3,948,945
2024-03-19,PROD019,Jilin,3,847,844
2024-03-20,PROD009,Jilin,2,383,381
2024-03-21,PROD006,Guangzhou,8,1169,1161
2024-03-22,PROD010,Guangzhou,10,1258,1248
2024-03-23,PROD020,Shanghai,5,412,407
2024-03-24,PROD006,Shanghai,8,374,366
2024-03-25,PROD018,Shanghai,8,893,885
2024-03-26,PROD012,Shenzhen,2,276,274
2024-03-27,PROD007,Beijing,8,253,245
2024-03-28,PROD020,Beijing,5,1026,1021
2024-03-29,PROD018,Guangzhou,6,969,963
2024-03-30,PROD004,Beijing,9,707,698
2024-03-31,PROD020,Jilin,8,1149,1141
2024-04-01,PROD005,Jilin,2,748,746
2024-04-02,PROD012,Shanghai,7,824,817
2024-04-03,PROD007,Guangzhou,3,945,942
2024-04-04,PROD019,Shanghai,6,1015,1009
2024-04-05,PROD001,Shanghai,10,983,973
2024-04-06,PROD016,Jilin,5,707,702
2024-04-07,PROD014,Guangzhou,1,342,341
2024-04-08,PROD020,Shanghai,5,407,402
2024-04-09,PROD001,Jilin,6,473,467
2024-04-10,PROD007,Beijing,1,245,244
2024-04-11,PROD007,Beijing,8,244,236
2024-04-12,PROD005,Jilin,8,746,738
2024-04-13,PROD016,Guangzhou,9,353,344
2024-04-14,PROD015,Jilin,7,1035,1028
2024-04-15,PROD011,Shanghai,10,570,560
2024-04-16,PROD010,Beijing,4,1272,1268
2024-04-17,PROD018,Jilin,10,1321,1311
2024-04-18,PROD010,Shanghai,2,601,599
2024-04-19,PROD002,Guangzhou,3,951,948
2024-04-20,PROD007,Jilin,2,310,308
2024-04-21,PROD004,Jilin,10,324,314
2024-04-22,PROD002,Jilin,6,884,878
2024-04-23,PROD011,Beijing,3,1323,1320
2024-04-24,PROD019,Jilin,2,844,842
2024-04-25,PROD013,Beijing,2,1047,1045
2024-04-26,PROD006,Jilin,3,822,819
2024-04-27,PROD012,Jilin,3,831,828
2024-04-28,PROD003,Beijing,5,1276,1271
2024-04-29,PROD007,Shenzhen,3,522,519
2024-04-30,PROD020,Beijing,4,1021,1017
2024-05-01,PROD003,Shenzhen,3,945,942
2024-05-02,PROD015,Shanghai,2,397,395
2024-05-03,PROD004,Guangzhou,8,1254,1246
2024-05-04,PROD008,Guangzhou,3,1231,1228
2024-05-05,PROD014,Shanghai,2,574,572
2024-05-06,PROD011,Jilin,9,441,432
2024-05-07,PROD015,Jilin,8,1028,1020
2024-05-08,PROD015,Shenzhen,10,794,784
2024-05-09,PROD017,Shanghai,10,740,730
2024-05-10,PROD011,Guangzhou,10,720,710
2024-05-11,PROD005,Guangzhou,1,485,484
2024-05-12,PROD016,Beijing,6,1106,1100
2024-05-13,PROD020,Shanghai,9,402,393
2024-05-14,PROD017,Guangzhou,1,386,385
2024-05-15,PROD014,Jilin,2,682,680
2024-05-16,PROD011,Beijing,8,1320,1312
2024-05-17,PROD009,Shenzhen,9,588,579
2024-05-18,PROD014,Jilin,8,680,672
2024-05-19,PROD020,Shenzhen,7,1099,1092
2024-05-20,PROD017,Shanghai,9,730,721
2024-05-21,PROD005,Beijing,2,670,668
2024-05-22,PROD016,Jilin,6,702,696
2024-05-23,PROD016,Jilin,10,696,686
2024-05-24,PROD018,Beijing,6,876,870
2024-05-25,PROD013,Shanghai,1,979,978
2024-05-26,PROD019,Shanghai,7,1009,1002
2024-05-27,PROD008,Shenzhen,4,712,708
2024-05-28,PROD011,Beijing,1,1312,1311
2024-05-29,PROD020,Beijing,8,1017,1009
2024-05-30,PROD006,Beijing,2,852,850
2024-05-31,PROD008,Shenzhen,3,708,705
2024-06-01,PROD019,Shanghai,2,1002,1000
2024-06-02,PROD018,Guangzhou,7,963,956
2024-06-03,PROD018,Beijing,5,870,865
2024-06-04,PROD011,Shanghai,3,560,557
2024-06-05,PROD002,Shenzhen,7,1089,1082
2024-06-06,PROD005,Guangzhou,1,484,483
2024-06-07,PROD019,Shenzhen,4,688,684
2024-06-08,PROD004,Jilin,8,314,306
2024-06-09,PROD002,Jilin,8,878,870
2024-06-10,PROD018,Guangzhou,9,956,947
2024-06-11,PROD005,Shanghai,4,749,745
2024-06-12,PROD012,Shanghai,10,817,807
2024-06-13,PROD006,Jilin,8,819,811
2024-06-14,PROD006,Shenzhen,1,374,373
2024-06-15,PROD014,Shenzhen,6,611,605
2024-06-16,PROD004,Shenzhen,6,443,437
2024-06-17,PROD019,Shenzhen,6,684,678
2024-06-18,PROD008,Jilin,2,608,606
2024-06-19,PROD003,Beijing,8,1271,1263
2024-06-20,PROD016,Guangzhou,3,344,341
2024-06-21,PROD004,Beijing,10,698,688
2024-06-22,PROD003,Jilin,4,1203,1199
2024-06-23,PROD011,Beijing,1,1311,1310
2024-06-24,PROD006,Shanghai,8,366,358
2024-06-25,PROD016,Jilin,1,686,685
2024-06-26,PROD012,Jilin,6,828,822
2024-06-27,PROD004,Beijing,3,688,685
2024-06-28,PROD012,Beijing,6,1061,1055
2024-06-29,PROD010,Beijing,1,1268,1267
2024-06-30,PROD014,Shenzhen,3,605,602
2024-07-01,PROD008,Jilin,7,606,599
2024-07-02,PROD008,Shanghai,6,364,358
2024-07-03,PROD020,Guangzhou,2,496,494
2024-07-04,PROD016,Guangzhou,1,341,340
2024-07-05,PROD020,Guangzhou,8,494,486
2024-07-06,PROD013,Shenzhen,3,1173,1170
2024-07-07,PROD009,Jilin,2,381,379
2024-07-08,PROD015,Shanghai,2,395,393
2024-07-09,PROD018,Jilin,3,1311,1308
2024-07-10,PROD015,Shanghai,3,393,390
2024-07-11,PROD013,Jilin,1,842,841
2024-07-12,PROD019,Shanghai,6,1000,994
2024-07-13,PROD008,Shanghai,7,358,351
2024-07-14,PROD020,Beijing,7,1009,1002
2024-07-15,PROD003,Jilin,3,1199,1196
2024-07-16,PROD008,Guangzhou,4,1228,1224
2024-07-17,PROD004,Jilin,6,306,300
2024-07-18,PROD020,Shanghai,4,393,389
2024-07-19,PROD009,Shanghai,9,539,530
2024-07-20,PROD011,Guangzhou,5,710,705
2024-07-21,PROD011,Guangzhou,6,705,699
2024-07-22,PROD012,Beijing,1,1055,1054
2024-07-23,PROD006,Shenzhen,5,373,368
2024-07-24,PROD011,Shenzhen,4,905,901
2024-07-25,PROD015,Guangzhou,10,684,674
2024-07-26,PROD014,Jilin,8,672,664
2024-07-27,PROD006,Beijing,3,850,847
2024-07-28,PROD007,Beijing,10,236,226
2024-07-29,PROD006,Shenzhen,1,368,367
2024-07-30,PROD003,Guangzhou,2,1010,1008
2024-07-31,PROD012,Shanghai,10,807,797
2024-08-01,PROD014,Shanghai,4,572,568
2024-08-02,PROD002,Jilin,5,870,865
2024-08-03,PROD005,Guangzhou,8,483,475
2024-08-04,PROD004,Guangzhou,10,1246,1236
2024-08-05,PROD003,Guangzhou,3,1008,1005
2024-08-06,PROD003,Guangzhou,7,1005,998
2024-08-07,PROD015,Shanghai,1,390,389
2024-08-08,PROD020,Shanghai,6,389,383
2024-08-09,PROD019,Jilin,10,842,832
2024-08-10,PROD006,Jilin,8,811,803
2024-08-11,PROD014,Beijing,9,518,509
2024-08-12,PROD002,Shanghai,3,497,494
2024-08-13,PROD015,Shenzhen,7,784,777
2024-08-14,PROD010,Shenzhen,7,883,876
2024-08-15,PROD005,Beijing,3,668,665
2024-08-16,PROD004,Shanghai,7,1246,1239
2024-08-17,PROD003,Shenzhen,5,942,937
2024-08-18,PROD016,Shanghai,2,1119,1117
2024-08-19,PROD001,Jilin,1,467,466
2024-08-20,PROD015,Shenzhen,8,777,769
2024-08-21,PROD011,Shanghai,10,557,547
2024-08-22,PROD008,Guangzhou,7,1224,1217
2024-08-23,PROD006,Jilin,2,803,801
2024-08-24,PROD012,Beijing,2,1054,1052
2024-08-25,PROD009,Shenzhen,3,579,576
2024-08-26,PROD003,Shanghai,7,1061,1054
2024-08-27,PROD008,Guangzhou,10,1217,1207
2024-08-28,PROD018,Jilin,1,1308,1307
2024-08-29,PROD014,Guangzhou,1,341,340
2024-08-30,PROD016,Shanghai,7,1117,1110
2024-08-31,PROD019,Jilin,6,832,826
2024-09-01,PROD006,Shanghai,10,358,348
2024-09-02,PROD009,Shenzhen,10,576,566
2024-09-03,PROD013,Shanghai,6,978,972
2024-09-04,PROD018,Guangzhou,8,947,939
2024-09-05,PROD013,Shanghai,2,972,970
2024-09-06,PROD001,Shanghai,2,973,971
2024-09-07,PROD005,Guangzhou,10,475,465
2024-09-08,PROD020,Beijing,6,1002,996
2024-09-09,PROD020,Beijing,4,996,992
2024-09-10,PROD012,Shenzhen,2,274,272
2024-09-11,PROD006,Guangzhou,5,1161,1156
2024-09-12,PROD020,Jilin,9,1141,1132
2024-09-13,PROD005,Jilin,7,738,731
2024-09-14,PROD010,Beijing,7,1267,1260
2024-09-15,PROD003,Guangzhou,7,998,991
2024-09-16,PROD013,Shenzhen,2,1170,1168
2024-09-17,PROD005,Jilin,6,731,725
2024-09-18,PROD014,Shanghai,5,568,563
2024-09-19,PROD007,Shanghai,7,540,533
2024-09-20,PROD019,Guangzhou,9,1151,1142
2024-09-21,PROD004,Shanghai,7,1239,1232
2024-09-22,PROD006,Beijing,6,847,841
2024-09-23,PROD007,Guangzhou,10,942,932
2024-09-24,PROD010,Beijing,2,1260,1258
2024-09-25,PROD009,Shanghai,10,530,520
2024-09-26,PROD017,Shenzhen,7,794,787
2024-09-27,PROD009,Beijing,4,490,486
2024-09-28,PROD006,Shenzhen,7,367,360
2024-09-29,PROD008,Guangzhou,6,1207,1201
2024-09-30,PROD017,Shenzhen,1,787,786
2024-10-01,PROD011,Guangzhou,2,699,697
2024-10-02,PROD009,Beijing,2,486,484
2024-10-03,PROD017,Jilin,3,1088,1085
2024-10-04,PROD002,Shenzhen,2,1082,1080
2024-10-05,PROD009,Guangzhou,9,1141,1132
2024-10-06,PROD008,Beijing,1,426,425
2024-10-07,PROD001,Jilin,7,466,459
2024-10-08,PROD013,Shenzhen,8,1168,1160
2024-10-09,PROD001,Jilin,9,459,450
2024-10-10,PROD018,Guangzhou,6,939,933
2024-10-11,PROD013,Shanghai,10,970,960
2024-10-12,PROD008,Beijing,8,425,417
2024-10-13,PROD012,Shenzhen,4,272,268
2024-10-14,PROD010,Jilin,10,395,385
2024-10-15,PROD003,Jilin,3,1196,1193
2024-10-16,PROD004,Guangzhou,8,1236,1228
2024-10-17,PROD001,Beijing,10,300,290
2024-10-18,PROD019,Shenzhen,7,678,671
2024-10-19,PROD019,Beijing,5,606,601
2024-10-20,PROD014,Beijing,6,509,503
2024-10-21,PROD003,Guangzhou,2,991,989
2024-10-22,PROD018,Beijing,5,865,860
2024-10-23,PROD012,Guangzhou,2,399,397
2024-10-24,PROD006,Shanghai,3,348,345
2024-10-25,PROD014,Guangzhou,5,340,335
2024-10-26,PROD002,Beijing,9,899,890
2024-10-27,PROD002,Shenzhen,5,1080,1075
2024-10-28,PROD017,Shanghai,9,721,712
2024-10-29,PROD018,Beijing,3,860,857
2024-10-30,PROD017,Jilin,6,1085,1079
2024-10-31,PROD014,Jilin,7,664,657
2024-11-01,PROD009,Shanghai,7,520,513
2024-11-02,PROD010,Shenzhen,7,876,869
2024-11-03,PROD001,Shanghai,2,971,969
2024-11-04,PROD020,Guangzhou,5,486,481
2024-11-05,PROD006,Shenzhen,3,360,357
2024-11-06,PROD013,Guangzhou,1,609,608
2024-11-07,PROD001,Beijing,9,290,281
2024-11-08,PROD007,Shenzhen,10,519,509
2024-11-09,PROD013,Shenzhen,9,1160,1151
2024-11-10,PROD014,Beijing,10,503,493
2024-11-11,PROD012,Guangzhou,4,397,393
2024-11-12,PROD019,Beijing,7,601,594
2024-11-13,PROD003,Jilin,6,1193,1187
2024-11-14,PROD007,Beijing,9,226,217
2024-11-15,PROD003,Beijing,9,1263,1254
2024-11-16,PROD004,Beijing,7,685,678
2024-11-17,PROD018,Shenzhen,2,1087,1085
2024-11-18,PROD015,Shenzhen,9,769,760
2024-11-19,PROD010,Guangzhou,3,1248,1245
2024-11-20,PROD015,Shenzhen,4,760,756
2024-11-21,PROD020,Jilin,2,1132,1130
2024-11-22,PROD007,Shenzhen,9,509,500
2024-11-23,PROD018,Beijing,1,857,856
2024-11-24,PROD010,Shanghai,1,599,598
2024-11-25,PROD006,Shenzhen,3,357,354
2024-11-26,PROD010,Jilin,3,385,382
2024-11-27,PROD010,Guangzhou,9,1245,1236
2024-11-28,PROD001,Guangzhou,2,1119,1117
2024-11-29,PROD004,Beijing,9,678,669
2024-11-30,PROD017,Beijing,3,1144,1141
2024-12-01,PROD017,Jilin,6,1079,1073
2024-12-02,PROD005,Beijing,7,665,658
2024-12-03,PROD002,Shenzhen,7,1075,1068
2024-12-04,PROD002,Shenzhen,3,1068,1065
2024-12-05,PROD005,Guangzhou,4,465,461
2024-12-06,PROD016,Beijing,8,1100,1092
2024-12-07,PROD004,Guangzhou,7,1228,1221
2024-12-08,PROD018,Shanghai,6,885,879
2024-12-09,PROD005,Guangzhou,3,461,458
2024-12-10,PROD018,Shenzhen,5,1085,1080
2024-12-11,PROD010,Guangzhou,9,1236,1227
2024-12-12,PROD014,Guangzhou,7,335,328
2024-12-13,PROD016,Shenzhen,2,383,381
2024-12-14,PROD003,Guangzhou,8,989,981
2024-12-15,PROD002,Guangzhou,7,948,941
2024-12-16,PROD020,Guangzhou,1,481,480
2024-12-17,PROD012,Guangzhou,5,393,388
2024-12-18,PROD019,Guangzhou,1,1142,1141
2024-12-19,PROD011,Guangzhou,5,697,692
2024-12-20,PROD010,Shanghai,10,598,588
2024-12-21,PROD008,Jilin,1,599,598
2024-12-22,PROD011,Beijing,8,1310,1302
2024-12-23,PROD012,Beijing,8,1052,1044
2024-12-24,PROD020,Jilin,7,1130,1123
2024-12-25,PROD011,Shenzhen,10,901,891
2024-12-26,PROD011,Guangzhou,9,692,683
2024-12-27,PROD004,Beijing,4,669,665
2024-12-28,PROD012,Jilin,4,822,818
2024-12-29,PROD017,Shenzhen,1,786,785
2024-12-30,PROD018,Jilin,6,1307,1301
2024-01-01,PROD013,Beijing,8,1045,1037
2024-01-02,PROD010,Guangzhou,2,1227,1225
2024-01-03,PROD002,Shenzhen,4,1065,1061
2024-01-04,PROD018,Guangzhou,4,933,929
2024-01-05,PROD002,Jilin,10,865,855
2024-01-06,PROD014,Shanghai,2,563,561
2024-01-07,PROD014,Guangzhou,6,328,322
2024-01-08,PROD016,Shenzhen,7,381,374
2024-01-09,PROD012,Beijing,4,1044,1040
2024-01-10,PROD003,Beijing,10,1254,1244
2024-01-11,PROD016,Shenzhen,8,374,366
2024-01-12,PROD011,Beijing,3,1302,1299
2024-01-13,PROD007,Guangzhou,6,932,926
2024-01-14,PROD018,Shenzhen,9,1080,1071
2024-01-15,PROD003,Shanghai,4,1054,1050
2024-01-16,PROD002,Shanghai,4,494,490
2024-01-17,PROD003,Beijing,8,1244,1236
2024-01-18,PROD017,Guangzhou,3,385,382
2024-01-19,PROD010,Shanghai,4,588,584
2024-01-20,PROD005,Shenzhen,2,599,597
2024-01-21,PROD002,Guangzhou,9,941,932
2024-01-22,PROD009,Shenzhen,1,566,565
2024-01-23,PROD010,Shenzhen,6,869,863
2024-01-24,PROD015,Shanghai,10,389,379
2024-01-25,PROD017,Shenzhen,8,785,777
2024-01-26,PROD007,Shanghai,5,533,528
2024-01-27,PROD008,Guangzhou,4,1201,1197
2024-01-28,PROD005,Jilin,8,725,717
2024-01-29,PROD016,Shenzhen,9,366,357
2024-01-30,PROD019,Shenzhen,6,671,665
2024-01-31,PROD014,Shanghai,10,561,551
2024-02-01,PROD003,Shenzhen,4,937,933
2024-02-02,PROD019,Shenzhen,3,665,662
2024-02-03,PROD006,Jilin,3,801,798
2024-02-04,PROD002,Shenzhen,6,1061,1055
2024-02-05,PROD008,Beijing,2,417,415
2024-02-06,PROD005,Beijing,10,658,648
2024-02-07,PROD010,Shenzhen,7,863,856
2024-02-08,PROD001,Guangzhou,10,1117,1107
2024-02-09,PROD009,Beijing,10,484,474
2024-02-10,PROD014,Guangzhou,9,322,313
2024-02-11,PROD010,Jilin,7,382,375
2024-02-12,PROD005,Guangzhou,7,458,451
2024-02-13,PROD011,Jilin,3,432,429
2024-02-14,PROD009,Beijing,5,474,469
2024-02-15,PROD002,Jilin,3,855,852
2024-02-16,PROD015,Guangzhou,5,674,669
2024-02-17,PROD015,Beijing,7,836,829
2024-02-18,PROD006,Jilin,10,798,788
2024-02-19,PROD002,Beijing,3,890,887
2024-02-20,PROD017,Jilin,5,1073,1068
2024-02-21,PROD014,Jilin,10,657,647
2024-02-22,PROD009,Guangzhou,3,1132,1129
2024-02-23,PROD013,Jilin,3,841,838
2024-02-24,PROD018,Beijing,10,856,846
2024-02-25,PROD007,Jilin,1,308,307
2024-02-26,PROD011,Jilin,1,429,428
2024-02-27,PROD011,Shanghai,6,547,541
2024-02-28,PROD009,Beijing,7,469,462
2024-02-29,PROD004,Guangzhou,4,1221,1217
2024-03-01,PROD012,Shanghai,10,797,787
2024-03-02,PROD003,Jilin,1,1187,1186
2024-03-03,PROD002,Beijing,2,887,885
2024-03-04,PROD018,Shanghai,8,879,871
2024-03-05,PROD002,Shanghai,4,490,486
2024-03-06,PROD007,Beijing,10,217,207
2024-03-07,PROD017,Shenzhen,3,777,774
2024-03-08,PROD018,Beijing,4,846,842
2024-03-09,PROD016,Shanghai,10,1110,1100
2024-03-10,PROD008,Guangzhou,1,1197,1196
2024-03-11,PROD019,Shenzhen,8,662,654
2024-03-12,PROD010,Shenzhen,9,856,847
2024-03-13,PROD002,Shenzhen,8,1055,1047
2024-03-14,PROD020,Beijing,7,992,985
2024-03-15,PROD017,Shanghai,1,712,711
2024-03-16,PROD014,Jilin,10,647,637
2024-03-17,PROD004,Beijing,5,665,660
2024-03-18,PROD015,Shanghai,2,379,377
2024-03-19,PROD019,Beijing,6,594,588
2024-03-20,PROD005,Shenzhen,4,597,593
2024-03-21,PROD008,Shanghai,3,351,348
2024-03-22,PROD005,Shenzhen,2,593,591
2024-03-23,PROD013,Shenzhen,10,1151,1141
2024-03-24,PROD009,Jilin,7,379,372
2024-03-25,PROD003,Guangzhou,2,981,979
2024-03-26,PROD005,Jilin,2,717,715
2024-03-27,PROD006,Shanghai,6,345,339
2024-03-28,PROD014,Shanghai,4,551,547
2024-03-29,PROD017,Shanghai,3,711,708
2024-03-30,PROD020,Beijing,7,985,978
2024-03-31,PROD013,Jilin,10,838,828
2024-04-01,PROD006,Shenzhen,4,354,350
2024-04-02,PROD018,Shanghai,10,871,861
2024-04-03,PROD004,Jilin,7,300,293
2024-04-04,PROD017,Beijing,5,1141,1136
2024-04-05,PROD017,Jilin,10,1068,1058
2024-04-06,PROD011,Jilin,7,428,421
2024-04-07,PROD001,Jilin,5,450,445
2024-04-08,PROD014,Guangzhou,4,313,309
2024-04-09,PROD001,Shanghai,1,969,968
2024-04-10,PROD004,Jilin,2,293,291
2024-04-11,PROD001,Guangzhou,10,1107,1097
2024-04-12,PROD003,Jilin,8,1186,1178
2024-04-13,PROD019,Shenzhen,6,654,648
2024-04-14,PROD002,Shanghai,6,486,480
2024-04-15,PROD016,Shanghai,5,1100,1095
2024-04-16,PROD014,Beijing,6,493,487
2024-04-17,PROD019,Shanghai,2,994,992
2024-04-18,PROD002,Beijing,6,885,879
2024-04-19,PROD004,Guangzhou,9,1217,1208
2024-04-20,PROD002,Shanghai,7,480,473
2024-04-21,PROD003,Jilin,10,1178,1168
2024-04-22,PROD018,Shenzhen,1,1071,1070
2024-04-23,PROD016,Shanghai,1,1095,1094
2024-04-24,PROD004,Jilin,10,291,281
2024-04-25,PROD012,Beijing,5,1040,1035
2024-04-26,PROD009,Shanghai,3,513,510
2024-04-27,PROD019,Guangzhou,8,1141,1133
2024-04-28,PROD016,Guangzhou,6,340,334
2024-04-29,PROD018,Shanghai,7,861,854
2024-04-30,PROD019,Jilin,5,826,821
2024-05-01,PROD007,Shenzhen,8,500,492
2024-05-02,PROD009,Beijing,8,462,454
2024-05-03,PROD003,Jilin,6,1168,1162
2024-05-04,PROD011,Guangzhou,3,683,680
2024-05-05,PROD003,Guangzhou,10,979,969
2024-05-06,PROD015,Guangzhou,9,669,660
2024-05-07,PROD003,Jilin,8,1162,1154
2024-05-08,PROD003,Beijing,5,1236,1231
2024-05-09,PROD013,Shanghai,2,960,958
2024-05-10,PROD004,Shanghai,6,1232,1226
2024-05-11,PROD011,Shanghai,6,541,535
2024-05-12,PROD006,Shenzhen,8,350,342
2024-05-13,PROD009,Shanghai,8,510,502
2024-05-14,PROD004,Shanghai,10,1226,1216
2024-05-15,PROD007,Shanghai,1,528,527
2024-05-16,PROD006,Jilin,7,788,781
2024-05-17,PROD012,Guangzhou,8,388,380
2024-05-18,PROD001,Shenzhen,8,586,578
2024-05-19,PROD010,Jilin,1,375,374
2024-05-20,PROD011,Jilin,6,421,415
2024-05-21,PROD016,Shenzhen,4,357,353
2024-05-22,PROD009,Guangzhou,9,1129,1120
2024-05-23,PROD010,Jilin,2,374,372
2024-05-24,PROD006,Guangzhou,2,1156,1154
2024-05-25,PROD002,Beijing,6,879,873
2024-05-26,PROD015,Beijing,4,829,825
2024-05-27,PROD017,Jilin,1,1058,1057
2024-05-28,PROD006,Shanghai,1,339,338
2024-05-29,PROD003,Shanghai,7,1050,1043
2024-05-30,PROD010,Shenzhen,10,847,837
2024-05-31,PROD017,Shenzhen,3,774,771
2024-06-01,PROD007,Shanghai,2,527,525
2024-06-02,PROD009,Beijing,8,454,446
2024-06-03,PROD012,Jilin,4,818,814
2024-06-04,PROD016,Jilin,1,685,684
2024-06-05,PROD002,Shenzhen,1,1047,1046
2024-06-06,PROD007,Jilin,7,307,300
2024-06-07,PROD008,Beijing,7,415,408
2024-06-08,PROD014,Beijing,8,487,479
2024-06-09,PROD012,Jilin,6,814,808
2024-06-10,PROD003,Beijing,5,1231,1226
2024-06-11,PROD013,Guangzhou,4,608,604
2024-06-12,PROD020,Shenzhen,6,1092,1086
2024-06-13,PROD019,Beijing,7,588,581
2024-06-14,PROD013,Shanghai,9,958,949
2024-06-15,PROD004,Shenzhen,6,437,431
2024-06-16,PROD001,Beijing,7,281,274
2024-06-17,PROD019,Guangzhou,8,1133,1125
2024-06-18,PROD016,Shenzhen,3,353,350
2024-06-19,PROD001,Shenzhen,7,578,571
2024-06-20,PROD018,Shanghai,7,854,847
2024-06-21,PROD004,Guangzhou,5,1208,1203
2024-06-22,PROD015,Jilin,7,1020,1013
2024-06-23,PROD005,Jilin,8,715,707
2024-06-24,PROD013,Guangzhou,6,604,598
2024-06-25,PROD007,Jilin,3,300,297
2024-06-26,PROD018,Jilin,3,1301,1298
2024-06-27,PROD005,Jilin,6,707,701
2024-06-28,PROD008,Jilin,2,598,596
2024-06-29,PROD008,Shanghai,1,348,347
2024-06-30,PROD013,Jilin,4,828,824
2024-07-01,PROD015,Shanghai,5,377,372
2024-07-02,PROD017,Beijing,8,1136,1128
2024-07-03,PROD003,Shenzhen,3,933,930
2024-07-04,PROD009,Beijing,2,446,444
2024-07-05,PROD019,Guangzhou,2,1125,1123
2024-07-06,PROD010,Beijing,8,1258,1250
2024-07-07,PROD019,Guangzhou,5,1123,1118
2024-07-08,PROD015,Shenzhen,3,756,753
2024-07-09,PROD011,Guangzhou,4,680,676
2024-07-10,PROD006,Jilin,10,781,771
2024-07-11,PROD018,Shenzhen,10,1070,1060
2024-07-12,PROD012,Jilin,4,808,804
2024-07-13,PROD004,Jilin,6,281,275
2024-07-14,PROD005,Beijing,8,648,640
2024-07-15,PROD006,Jilin,9,771,762
2024-07-16,PROD007,Shanghai,5,525,520
2024-07-17,PROD005,Shenzhen,2,591,589
2024-07-18,PROD010,Guangzhou,6,1225,1219
2024-07-19,PROD008,Guangzhou,6,1196,1190
2024-07-20,PROD004,Jilin,4,275,271
2024-07-21,PROD015,Beijing,8,825,817
2024-07-22,PROD002,Jilin,2,852,850
2024-07-23,PROD001,Beijing,6,274,268
2024-07-24,PROD016,Shanghai,9,1094,1085
2024-07-25,PROD003,Guangzhou,7,969,962
2024-07-26,PROD004,Beijing,3,660,657
2024-07-27,PROD018,Shanghai,9,847,838
2024-07-28,PROD013,Jilin,7,824,817
2024-07-29,PROD015,Beijing,4,817,813
2024-07-30,PROD001,Beijing,6,268,262
2024-07-31,PROD017,Shenzhen,4,771,767
2024-08-01,PROD005,Beijing,5,640,635
2024-08-02,PROD013,Shenzhen,1,1141,1140
2024-08-03,PROD002,Beijing,8,873,865
2024-08-04,PROD018,Guangzhou,2,929,927
2024-08-05,PROD006,Shenzhen,9,342,333
2024-08-06,PROD005,Shenzhen,6,589,583
2024-08-07,PROD003,Beijing,4,1226,1222
2024-08-08,PROD012,Shenzhen,4,268,264
2024-08-09,PROD007,Shenzhen,2,492,490
2024-08-10,PROD007,Jilin,5,297,292
2024-08-11,PROD005,Shenzhen,6,583,577
2024-08-12,PROD015,Shenzhen,3,753,750
2024-08-13,PROD019,Shanghai,9,992,983
2024-08-14,PROD020,Jilin,8,1123,1115
2024-08-15,PROD018,Shenzhen,7,1060,1053
2024-08-16,PROD013,Shanghai,9,949,940
2024-08-17,PROD005,Beijing,9,635,626
2024-08-18,PROD004,Guangzhou,1,1203,1202
2024-08-19,PROD005,Beijing,5,626,621
2024-08-20,PROD001,Jilin,10,445,435
2024-08-21,PROD015,Beijing,9,813,804
2024-08-22,PROD015,Guangzhou,10,660,650
2024-08-23,PROD005,Jilin,2,701,699
2024-08-24,PROD018,Jilin,10,1298,1288
2024-08-25,PROD005,Beijing,2,621,619
2024-08-26,PROD004,Beijing,6,657,651
2024-08-27,PROD014,Jilin,9,637,628
2024-08-28,PROD012,Shenzhen,4,264,260
2024-08-29,PROD014,Shanghai,10,547,537
2024-08-30,PROD010,Shenzhen,10,837,827
2024-08-31,PROD001,Beijing,5,262,257
2024-09-01,PROD017,Shenzhen,6,767,761
2024-09-02,PROD010,Jilin,6,372,366
2024-09-03,PROD020,Shanghai,5,383,378
2024-09-04,PROD003,Shanghai,10,1043,1033
2024-09-05,PROD019,Jilin,2,821,819
2024-09-06,PROD012,Shanghai,2,787,785
2024-09-07,PROD010,Shanghai,4,584,580
2024-09-08,PROD014,Shenzhen,10,602,592
2024-09-09,PROD017,Shenzhen,3,761,758
2024-09-10,PROD007,Shenzhen,9,490,481
2024-09-11,PROD002,Shanghai,2,473,471
2024-09-12,PROD006,Shanghai,3,338,335
2024-09-13,PROD013,Guangzhou,3,598,595
2024-09-14,PROD018,Shenzhen,6,1053,1047
2024-09-15,PROD018,Beijing,9,842,833
2024-09-16,PROD003,Beijing,10,1222,1212
2024-09-17,PROD014,Guangzhou,8,309,301
2024-09-18,PROD013,Jilin,4,817,813
2024-09-19,PROD004,Beijing,3,651,648
2024-09-20,PROD020,Guangzhou,7,480,473
2024-09-21,PROD018,Shanghai,10,838,828
2024-09-22,PROD006,Jilin,1,762,761
2024-09-23,PROD007,Beijing,1,207,206
2024-09-24,PROD014,Jilin,6,628,622
2024-09-25,PROD006,Shenzhen,4,333,329
2024-09-26,PROD020,Shenzhen,6,1086,1080
2024-09-27,PROD003,Beijing,3,1212,1209
2024-09-28,PROD015,Shenzhen,9,750,741
2024-09-29,PROD008,Guangzhou,1,1190,1189
2024-09-30,PROD012,Beijing,4,1035,1031
2024-10-01,PROD008,Shanghai,3,347,344
2024-10-02,PROD011,Shenzhen,9,891,882
2024-10-03,PROD004,Beijing,10,648,638
2024-10-04,PROD017,Beijing,5,1128,1123
2024-10-05,PROD005,Guangzhou,8,451,443
2024-10-06,PROD015,Shenzhen,7,741,734
2024-10-07,PROD001,Shenzhen,9,571,562
2024-10-08,PROD002,Shanghai,10,471,461
2024-10-09,PROD011,Shenzhen,1,882,881
2024-10-10,PROD012,Guangzhou,8,380,372
2024-10-11,PROD002,Shanghai,9,461,452
2024-10-12,PROD010,Jilin,2,366,364
2024-10-13,PROD001,Shanghai,2,968,966
2024-10-14,PROD017,Shanghai,2,708,706
2024-10-15,PROD003,Shanghai,7,1033,1026
2024-10-16,PROD004,Guangzhou,8,1202,1194
2024-10-17,PROD005,Shanghai,4,745,741
2024-10-18,PROD001,Beijing,7,257,250
2024-10-19,PROD013,Guangzhou,2,595,593
2024-10-20,PROD012,Guangzhou,2,372,370
2024-10-21,PROD018,Jilin,10,1288,1278
2024-10-22,PROD012,Beijing,5,1031,1026
2024-10-23,PROD020,Shenzhen,8,1080,1072
2024-10-24,PROD008,Jilin,5,596,591
2024-10-25,PROD004,Shanghai,9,1216,1207
2024-10-26,PROD016,Jilin,3,684,681
2024-10-27,PROD002,Shenzhen,1,1046,1045
2024-10-28,PROD002,Shanghai,1,452,451
2024-10-29,PROD004,Beijing,10,638,628
2024-10-30,PROD003,Jilin,1,1154,1153
2024-10-31,PROD020,Beijing,3,978,975
2024-11-01,PROD002,Beijing,6,865,859
2024-11-02,PROD017,Beijing,1,1123,1122
2024-11-03,PROD003,Shenzhen,6,930,924
2024-11-04,PROD013,Beijing,6,1037,1031
2024-11-05,PROD002,Jilin,8,850,842
2024-11-06,PROD002,Shanghai,4,451,447
2024-11-07,PROD005,Guangzhou,8,443,435
2024-11-08,PROD012,Beijing,5,1026,1021
2024-11-09,PROD020,Shanghai,10,378,368
2024-11-10,PROD005,Beijing,4,619,615
2024-11-11,PROD012,Jilin,5,804,799
2024-11-12,PROD001,Guangzhou,8,1097,1089
2024-11-13,PROD017,Beijing,9,1122,1113
2024-11-14,PROD020,Guangzhou,5,473,468
2024-11-15,PROD001,Beijing,4,250,246
2024-11-16,PROD020,Beijing,5,975,970
2024-11-17,PROD019,Guangzhou,9,1118,1109
2024-11-18,PROD008,Shenzhen,3,705,702
2024-11-19,PROD010,Jilin,8,364,356
2024-11-20,PROD006,Shenzhen,4,329,325
2024-11-21,PROD002,Jilin,3,842,839
2024-11-22,PROD015,Shenzhen,5,734,729
2024-11-23,PROD001,Shanghai,10,966,956
2024-11-24,PROD007,Jilin,7,292,285
2024-11-25,PROD020,Beijing,4,970,966
2024-11-26,PROD005,Guangzhou,5,435,430
2024-11-27,PROD019,Shanghai,1,983,982
2024-11-28,PROD010,Shenzhen,4,827,823
2024-11-29,PROD015,Guangzhou,2,650,648
2024-11-30,PROD017,Guangzhou,10,382,372
2024-12-01,PROD004,Shenzhen,1,431,430
2024-12-02,PROD020,Shanghai,7,368,361
2024-12-03,PROD016,Guangzhou,2,334,332
2024-12-04,PROD003,Jilin,10,1153,1143
2024-12-05,PROD009,Beijing,1,444,443
2024-12-06,PROD016,Jilin,10,681,671
2024-12-07,PROD020,Jilin,4,1115,1111
2024-12-08,PROD010,Guangzhou,10,1219,1209
2024-12-09,PROD018,Guangzhou,9,927,918
2024-12-10,PROD007,Jilin,2,285,283
2024-12-11,PROD009,Shanghai,1,502,501
2024-12-12,PROD001,Shenzhen,4,562,558
2024-12-13,PROD002,Guangzhou,8,932,924
2024-12-14,PROD018,Guangzhou,9,918,909
2024-12-15,PROD007,Jilin,1,283,282
2024-12-16,PROD008,Shenzhen,1,702,701
2024-12-17,PROD018,Shanghai,9,828,819
2024-12-18,PROD018,Beijing,3,833,830
2024-12-19,PROD018,Guangzhou,8,909,901
2024-12-20,PROD012,Shenzhen,5,260,255
2024-12-21,PROD009,Jilin,1,372,371
2024-12-22,PROD006,Jilin,5,761,756
2024-12-23,PROD011,Beijing,4,1299,1295
2024-12-24,PROD018,Shanghai,5,819,814
2024-12-25,PROD020,Beijing,3,966,963
2024-12-26,PROD003,Guangzhou,5,962,957
2024-12-27,PROD012,Jilin,2,799,797
2024-12-28,PROD008,Jilin,4,591,587
2024-12-29,PROD011,Beijing,7,1295,1288
2024-12-30,PROD002,Shanghai,6,447,441
2024-01-01,PROD004,Jilin,2,271,269
2024-01-02,PROD011,Beijing,6,1288,1282
2024-01-03,PROD017,Shanghai,3,706,703
2024-01-04,PROD018,Beijing,2,830,828
2024-01-05,PROD020,Beijing,4,963,959
2024-01-06,PROD019,Guangzhou,9,1109,1100
2024-01-07,PROD019,Shanghai,5,982,977
2024-01-08,PROD009,Jilin,9,371,362
2024-01-09,PROD008,Guangzhou,2,1189,1187
2024-01-10,PROD020,Shanghai,6,361,355
2024-01-11,PROD002,Beijing,4,859,855
2024-01-12,PROD016,Beijing,6,1092,1086
2024-01-13,PROD019,Jilin,2,819,817
2024-01-14,PROD006,Shanghai,10,335,325
2024-01-15,PROD014,Shenzhen,9,592,583
2024-01-16,PROD010,Jilin,4,356,352
2024-01-17,PROD012,Beijing,7,1021,1014
2024-01-18,PROD003,Shanghai,9,1026,1017
2024-01-19,PROD013,Shanghai,7,940,933
2024-01-20,PROD010,Jilin,4,352,348
2024-01-21,PROD003,Shanghai,5,1017,1012
2024-01-22,PROD001,Shanghai,9,956,947
2024-01-23,PROD010,Guangzhou,5,1209,1204
2024-01-24,PROD012,Beijing,10,1014,1004
2024-01-25,PROD014,Beijing,3,479,476
2024-01-26,PROD011,Shanghai,6,535,529
2024-01-27,PROD019,Shenzhen,9,648,639
2024-01-28,PROD008,Beijing,4,408,404
2024-01-29,PROD011,Jilin,3,415,412
2024-01-30,PROD009,Guangzhou,3,1120,1117
2024-01-31,PROD004,Shanghai,10,1207,1197
2024-02-01,PROD008,Jilin,7,587,580
2024-02-02,PROD017,Guangzhou,3,372,369
2024-02-03,PROD009,Jilin,5,362,357
2024-02-04,PROD011,Shanghai,9,529,520
2024-02-05,PROD009,Beijing,7,443,436
2024-02-06,PROD007,Shenzhen,1,481,480
2024-02-07,PROD010,Beijing,5,1250,1245
2024-02-08,PROD011,Shanghai,4,520,516
2024-02-09,PROD019,Shanghai,2,977,975
2024-02-10,PROD006,Guangzhou,2,1154,1152
2024-02-11,PROD008,Shenzhen,3,701,698
2024-02-12,PROD011,Shenzhen,9,881,872
2024-02-13,PROD006,Guangzhou,8,1152,1144
2024-02-14,PROD006,Beijing,4,841,837
2024-02-15,PROD016,Guangzhou,3,332,329
2024-02-16,PROD003,Beijing,7,1209,1202
2024-02-17,PROD012,Jilin,4,797,793
2024-02-18,PROD006,Guangzhou,10,1144,1134
2024-02-19,PROD009,Beijing,7,436,429
2024-02-20,PROD015,Guangzhou,2,648,646
2024-02-21,PROD015,Beijing,4,804,800
2024-02-22,PROD006,Shanghai,6,325,319
2024-02-23,PROD017,Guangzhou,8,369,361
2024-02-24,PROD020,Jilin,9,1111,1102
2024-02-25,PROD002,Guangzhou,3,924,921
2024-02-26,PROD020,Shenzhen,8,1072,1064
2024-02-27,PROD008,Shanghai,1,344,343
2024-02-28,PROD015,Shanghai,3,372,369
2024-02-29,PROD017,Shenzhen,2,758,756
2024-03-01,PROD014,Jilin,6,622,616
2024-03-02,PROD001,Guangzhou,2,1089,1087
2024-03-03,PROD006,Shanghai,7,319,312
2024-03-04,PROD002,Guangzhou,1,921,920
2024-03-05,PROD020,Guangzhou,7,468,461
2024-03-06,PROD019,Guangzhou,9,1100,1091
2024-03-07,PROD004,Shenzhen,3,430,427
2024-03-08,PROD011,Shenzhen,5,872,867
2024-03-09,PROD018,Shanghai,10,814,804
2024-03-10,PROD003,Beijing,10,1202,1192
2024-03-11,PROD020,Guangzhou,1,461,460
2024-03-12,PROD019,Beijing,2,581,579
2024-03-13,PROD009,Jilin,9,357,348
2024-03-14,PROD016,Jilin,6,671,665
2024-03-15,PROD007,Shenzhen,6,480,474
2024-03-16,PROD017,Shenzhen,4,756,752
2024-03-17,PROD009,Jilin,7,348,341
2024-03-18,PROD012,Shenzhen,10,255,245
2024-03-19,PROD002,Jilin,10,839,829
2024-03-20,PROD014,Shanghai,1,537,536
2024-03-21,PROD015,Shenzhen,2,729,727
2024-03-22,PROD001,Guangzhou,5,1087,1082
2024-03-23,PROD020,Jilin,7,1102,1095
2024-03-24,PROD013,Jilin,5,813,808
2024-03-25,PROD015,Beijing,5,800,795
2024-03-26,PROD009,Guangzhou,9,1117,1108
2024-03-27,PROD001,Shenzhen,2,558,556
2024-03-28,PROD006,Shenzhen,4,325,321
2024-03-29,PROD016,Shanghai,7,1085,1078
2024-03-30,PROD010,Shanghai,2,580,578
2024-03-31,PROD003,Shanghai,2,1012,1010
2024-04-01,PROD015,Shenzhen,10,727,717
2024-04-02,PROD017,Guangzhou,4,361,357
2024-04-03,PROD001,Shenzhen,3,556,553
2024-04-04,PROD014,Beijing,8,476,468
2024-04-05,PROD016,Shenzhen,5,350,345
2024-04-06,PROD019,Jilin,2,817,815
2024-04-07,PROD004,Shanghai,9,1197,1188
2024-04-08,PROD005,Guangzhou,8,430,422
2024-04-09,PROD005,Beijing,4,615,611
2024-04-10,PROD009,Guangzhou,9,1108,1099
2024-04-11,PROD018,Jilin,10,1278,1268
2024-04-12,PROD018,Shanghai,1,804,803
2024-04-13,PROD015,Jilin,2,1013,1011
2024-04-14,PROD019,Guangzhou,1,1091,1090
2024-04-15,PROD004,Shenzhen,9,427,418
2024-04-16,PROD017,Guangzhou,8,357,349
2024-04-17,PROD020,Shanghai,4,355,351
2024-04-18,PROD020,Shanghai,3,351,348
2024-04-19,PROD008,Jilin,10,580,570
2024-04-20,PROD004,Beijing,1,628,627
2024-04-21,PROD020,Beijing,5,959,954
2024-04-22,PROD007,Guangzhou,7,926,919
2024-04-23,PROD004,Shenzhen,4,418,414
2024-04-24,PROD008,Jilin,2,570,568
2024-04-25,PROD020,Guangzhou,2,460,458
2024-04-26,PROD015,Jilin,6,1011,1005
2024-04-27,PROD005,Beijing,2,611,609
2024-04-28,PROD020,Shenzhen,9,1064,1055
2024-04-29,PROD019,Shenzhen,3,639,636
2024-04-30,PROD006,Guangzhou,10,1134,1124
2024-05-01,PROD008,Shenzhen,8,698,690
2024-05-02,PROD006,Guangzhou,6,1124,1118
2024-05-03,PROD017,Guangzhou,3,349,346
2024-05-04,PROD018,Shenzhen,5,1047,1042
2024-05-05,PROD009,Shenzhen,4,565,561
2024-05-06,PROD006,Beijing,4,837,833
2024-05-07,PROD011,Jilin,5,412,407
2024-05-08,PROD008,Shenzhen,5,690,685
2024-05-09,PROD002,Beijing,6,855,849
2024-05-10,PROD006,Shanghai,6,312,306
2024-05-11,PROD008,Jilin,4,568,564
2024-05-12,PROD009,Shanghai,8,501,493
2024-05-13,PROD008,Beijing,1,404,403
2024-05-14,PROD013,Shanghai,8,933,925
2024-05-15,PROD016,Guangzhou,1,329,328
2024-05-16,PROD007,Beijing,5,206,201
2024-05-17,PROD016,Guangzhou,6,328,322
2024-05-18,PROD005,Guangzhou,8,422,414
2024-05-19,PROD018,Shanghai,7,803,796
2024-05-20,PROD014,Shanghai,7,536,529
2024-05-21,PROD014,Beijing,5,468,463
2024-05-22,PROD004,Jilin,4,269,265
2024-05-23,PROD011,Beijing,1,1282,1281
2024-05-24,PROD006,Jilin,7,756,749
2024-05-25,PROD002,Shenzhen,8,1045,1037
2024-05-26,PROD011,Guangzhou,8,676,668
2024-05-27,PROD007,Jilin,7,282,275
2024-05-28,PROD006,Shanghai,5,306,301
2024-05-29,PROD019,Shenzhen,4,636,632
2024-05-30,PROD010,Beijing,9,1245,1236
2024-05-31,PROD004,Shanghai,5,1188,1183
2024-06-01,PROD017,Jilin,10,1057,1047
2024-06-02,PROD019,Shenzhen,5,632,627
2024-06-03,PROD019,Shenzhen,4,627,623
2024-06-04,PROD015,Shanghai,7,369,362
2024-06-05,PROD001,Guangzhou,9,1082,1073
2024-06-06,PROD017,Shanghai,7,703,696
2024-06-07,PROD005,Shanghai,1,741,740
2024-06-08,PROD010,Shanghai,8,578,570
2024-06-09,PROD010,Beijing,2,1236,1234
2024-06-10,PROD010,Jilin,7,348,341
2024-06-11,PROD008,Jilin,10,564,554
2024-06-12,PROD020,Guangzhou,8,458,450
2024-06-13,PROD016,Jilin,7,665,658
2024-06-14,PROD001,Beijing,8,246,238
2024-06-15,PROD002,Shenzhen,1,1037,1036
2024-06-16,PROD015,Shanghai,10,362,352
2024-06-17,PROD007,Beijing,9,201,192
2024-06-18,PROD007,Beijing,7,192,185
2024-06-19,PROD019,Beijing,2,579,577
2024-06-20,PROD010,Shenzhen,1,823,822
2024-06-21,PROD001,Shanghai,1,947,946
2024-06-22,PROD002,Guangzhou,3,920,917
2024-06-23,PROD019,Shanghai,3,975,972
2024-06-24,PROD016,Beijing,4,1086,1082
2024-06-25,PROD012,Shanghai,5,785,780
2024-06-26,PROD016,Jilin,1,658,657
2024-06-27,PROD015,Guangzhou,7,646,639
2024-06-28,PROD010,Shanghai,10,570,560
2024-06-29,PROD017,Shenzhen,5,752,747
2024-06-30,PROD019,Beijing,6,577,571
2024-07-01,PROD012,Guangzhou,6,370,364
2024-07-02,PROD005,Shenzhen,10,577,567
2024-07-03,PROD010,Shenzhen,8,822,814
2024-07-04,PROD013,Jilin,4,808,804
2024-07-05,PROD015,Beijing,3,795,792
2024-07-06,PROD001,Shenzhen,8,553,545
2024-07-07,PROD008,Shanghai,6,343,337
2024-07-08,PROD007,Beijing,3,185,182
2024-07-09,PROD004,Shanghai,6,1183,1177
2024-07-10,PROD012,Shenzhen,2,245,243
2024-07-11,PROD011,Shenzhen,1,867,866
2024-07-12,PROD020,Shanghai,4,348,344
2024-07-13,PROD016,Guangzhou,5,322,317
2024-07-14,PROD013,Shenzhen,10,1140,1130
2024-07-15,PROD006,Shanghai,7,301,294
2024-07-16,PROD002,Jilin,10,829,819
2024-07-17,PROD020,Shanghai,10,344,334
2024-07-18,PROD012,Guangzhou,9,364,355
2024-07-19,PROD019,Guangzhou,2,1090,1088
2024-07-20,PROD005,Guangzhou,9,414,405
2024-07-21,PROD003,Beijing,7,1192,1185
2024-07-22,PROD019,Shenzhen,6,623,617
2024-07-23,PROD010,Shanghai,9,560,551
2024-07-24,PROD012,Shenzhen,4,243,239
2024-07-25,PROD003,Shanghai,1,1010,1009
2024-07-26,PROD006,Shenzhen,2,321,319
2024-07-27,PROD016,Shenzhen,10,345,335
2024-07-28,PROD015,Jilin,8,1005,997
2024-07-29,PROD011,Shenzhen,7,866,859
2024-07-30,PROD013,Beijing,2,1031,1029
2024-07-31,PROD001,Shenzhen,10,545,535
2024-08-01,PROD015,Beijing,2,792,790
2024-08-02,PROD010,Jilin,2,341,339
2024-08-03,PROD014,Shenzhen,2,583,581
2024-08-04,PROD012,Beijing,9,1004,995
2024-08-05,PROD019,Guangzhou,9,1088,1079
2024-08-06,PROD001,Shanghai,1,946,945
2024-08-07,PROD008,Shanghai,4,337,333
2024-08-08,PROD017,Jilin,5,1047,1042
2024-08-09,PROD013,Shanghai,7,925,918
2024-08-10,PROD001,Shanghai,2,945,943
2024-08-11,PROD007,Jilin,2,275,273
2024-08-12,PROD019,Shanghai,3,972,969
2024-08-13,PROD019,Shanghai,8,969,961
2024-08-14,PROD009,Jilin,7,341,334
2024-08-15,PROD017,Beijing,4,1113,1109
2024-08-16,PROD008,Beijing,2,403,401
2024-08-17,PROD016,Jilin,5,657,652
2024-08-18,PROD002,Beijing,10,849,839
2024-08-19,PROD001,Beijing,6,238,232
2024-08-20,PROD019,Guangzhou,6,1079,1073
2024-08-21,PROD013,Beijing,2,1029,1027
2024-08-22,PROD019,Beijing,1,571,570
2024-08-23,PROD004,Shanghai,2,1177,1175
2024-08-24,PROD012,Shenzhen,2,239,237
2024-08-25,PROD014,Jilin,6,616,610
2024-08-26,PROD015,Shenzhen,5,717,712
2024-08-27,PROD008,Jilin,5,554,549
2024-08-28,PROD008,Shenzhen,4,685,681
2024-08-29,PROD013,Jilin,2,804,802
2024-08-30,PROD006,Shanghai,6,294,288
2024-08-31,PROD004,Beijing,1,627,626
2024-09-01,PROD004,Beijing,2,626,624
2024-09-02,PROD016,Shanghai,7,1078,1071
2024-09-03,PROD004,Jilin,4,265,261
2024-09-04,PROD001,Shanghai,4,943,939
2024-09-05,PROD009,Guangzhou,3,1099,1096
2024-09-06,PROD020,Guangzhou,10,450,440
2024-09-07,PROD016,Shanghai,4,1071,1067
2024-09-08,PROD016,Guangzhou,1,317,316
2024-09-09,PROD005,Shenzhen,4,567,563
2024-09-10,PROD012,Beijing,5,995,990
2024-09-11,PROD001,Shanghai,9,939,930
2024-09-12,PROD004,Shenzhen,3,414,411
2024-09-13,PROD004,Beijing,8,624,616
2024-09-14,PROD013,Guangzhou,9,593,584
2024-09-15,PROD011,Guangzhou,6,668,662
2024-09-16,PROD019,Beijing,1,570,569
2024-09-17,PROD007,Guangzhou,5,919,914
2024-09-18,PROD012,Guangzhou,10,355,345
2024-09-19,PROD005,Shenzhen,6,563,557
2024-09-20,PROD015,Shanghai,3,352,349
2024-09-21,PROD019,Shanghai,4,961,957
2024-09-22,PROD010,Beijing,8,1234,1226
2024-09-23,PROD015,Shenzhen,2,712,710
2024-09-24,PROD015,Guangzhou,1,639,638
2024-09-25,PROD018,Beijing,1,828,827
2024-09-26,PROD016,Shenzhen,3,335,332
2024-09-27,PROD003,Jilin,8,1143,1135
2024-09-28,PROD004,Jilin,5,261,256
2024-09-29,PROD011,Guangzhou,4,662,658
2024-09-30,PROD006,Shanghai,10,288,278
2024-10-01,PROD017,Guangzhou,7,346,339
2024-10-02,PROD015,Beijing,1,790,789
2024-10-03,PROD015,Beijing,2,789,787
2024-10-04,PROD007,Shenzhen,3,474,471
2024-10-05,PROD009,Jilin,1,334,333
2024-10-06,PROD002,Jilin,7,819,812
2024-10-07,PROD008,Jilin,9,549,540
2024-10-08,PROD019,Shenzhen,9,617,608
2024-10-09,PROD016,Shanghai,5,1067,1062
2024-10-10,PROD010,Beijing,6,1226,1220
2024-10-11,PROD007,Shanghai,5,520,515
2024-10-12,PROD006,Guangzhou,9,1118,1109
2024-10-13,PROD015,Shenzhen,7,710,703
2024-10-14,PROD003,Shanghai,4,1009,1005
2024-10-15,PROD020,Shanghai,3,334,331
2024-10-16,PROD013,Jilin,4,802,798
2024-10-17,PROD006,Beijing,4,833,829
2024-10-18,PROD009,Jilin,1,333,332
2024-10-19,PROD013,Shenzhen,8,1130,1122
2024-10-20,PROD016,Jilin,7,652,645
2024-10-21,PROD010,Shenzhen,2,814,812
2024-10-22,PROD001,Jilin,5,435,430
2024-10-23,PROD019,Jilin,2,815,813
2024-10-24,PROD012,Guangzhou,4,345,341
2024-10-25,PROD019,Jilin,7,813,806
2024-10-26,PROD011,Jilin,1,407,406
2024-10-27,PROD006,Shanghai,3,278,275
2024-10-28,PROD012,Shanghai,3,780,777
2024-10-29,PROD014,Shenzhen,3,581,578
2024-10-30,PROD007,Guangzhou,9,914,905
2024-10-31,PROD004,Guangzhou,5,1194,1189
2024-11-01,PROD018,Beijing,9,827,818
2024-11-02,PROD004,Beijing,1,616,615
2024-11-03,PROD010,Beijing,8,1220,1212
2024-11-04,PROD020,Jilin,10,1095,1085
2024-11-05,PROD014,Beijing,1,463,462
2024-11-06,PROD020,Jilin,9,1085,1076
2024-11-07,PROD017,Shenzhen,10,747,737
2024-11-08,PROD005,Beijing,3,609,606
2024-11-09,PROD013,Jilin,8,798,790
2024-11-10,PROD003,Beijing,2,1185,1183
2024-11-11,PROD020,Guangzhou,4,440,436
2024-11-12,PROD003,Shenzhen,2,924,922
2024-11-13,PROD019,Jilin,3,806,803
2024-11-14,PROD011,Shanghai,2,516,514
2024-11-15,PROD017,Jilin,5,1042,1037
2024-11-16,PROD014,Guangzhou,2,301,299
2024-11-17,PROD003,Guangzhou,9,957,948
2024-11-18,PROD018,Shenzhen,1,1042,1041
2024-11-19,PROD016,Shenzhen,3,332,329
2024-11-20,PROD004,Shanghai,5,1175,1170
2024-11-21,PROD017,Shenzhen,5,737,732
2024-11-22,PROD001,Guangzhou,2,1073,1071
2024-11-23,PROD001,Shanghai,10,930,920
2024-11-24,PROD020,Jilin,6,1076,1070
2024-11-25,PROD014,Guangzhou,3,299,296
2024-11-26,PROD015,Guangzhou,3,638,635
2024-11-27,PROD014,Jilin,4,610,606
2024-11-28,PROD009,Shenzhen,8,561,553
2024-11-29,PROD018,Jilin,4,1268,1264
2024-11-30,PROD009,Beijing,3,429,426
2024-12-01,PROD015,Shenzhen,6,703,697
2024-12-02,PROD018,Guangzhou,2,901,899
2024-12-03,PROD002,Beijing,9,839,830
2024-12-04,PROD017,Shenzhen,2,732,730
2024-12-05,PROD011,Beijing,3,1281,1278
2024-12-06,PROD011,Shanghai,3,514,511
2024-12-07,PROD008,Guangzhou,4,1187,1183
2024-12-08,PROD004,Shenzhen,3,411,408
2024-12-09,PROD018,Beijing,7,818,811
2024-12-10,PROD009,Shenzhen,2,553,551
2024-12-11,PROD019,Beijing,5,569,564
2024-12-12,PROD006,Shanghai,3,275,272
2024-12-13,PROD011,Shanghai,3,511,508
2024-12-14,PROD001,Guangzhou,5,1071,1066
2024-12-15,PROD020,Jilin,1,1070,1069
2024-12-16,PROD011,Guangzhou,10,658,648
2024-12-17,PROD003,Guangzhou,2,948,946
2024-12-18,PROD017,Shanghai,3,696,693
2024-12-19,PROD018,Shanghai,10,796,786
2024-12-20,PROD019,Jilin,9,803,794
2024-12-21,PROD016,Shenzhen,7,329,322
2024-12-22,PROD015,Jilin,8,997,989
2024-12-23,PROD012,Beijing,10,990,980
2024-12-24,PROD002,Guangzhou,10,917,907
2024-12-25,PROD013,Shenzhen,3,1122,1119
2024-12-26,PROD003,Shenzhen,1,922,921
2024-12-27,PROD016,Jilin,10,645,635
2024-12-28,PROD008,Jilin,1,540,539
2024-12-29,PROD013,Shenzhen,10,1119,1109
2024-12-30,PROD016,Jilin,6,635,629
2024-01-01,PROD005,Jilin,4,699,695
2024-01-02,PROD020,Beijing,5,954,949
2024-01-03,PROD017,Beijing,3,1109,1106
2024-01-04,PROD010,Shanghai,5,551,546
2024-01-05,PROD017,Guangzhou,1,339,338
2024-01-06,PROD001,Shanghai,4,920,916
2024-01-07,PROD006,Shanghai,5,272,267
2024-01-08,PROD017,Shenzhen,6,730,724
2024-01-09,PROD011,Shenzhen,6,859,853
2024-01-10,PROD014,Guangzhou,2,296,294
2024-01-11,PROD019,Shenzhen,2,608,606
2024-01-12,PROD010,Shenzhen,2,812,810
2024-01-13,PROD010,Shanghai,2,546,544
2024-01-14,PROD006,Guangzhou,4,1109,1105
2024-01-15,PROD004,Jilin,9,256,247
2024-01-16,PROD002,Shanghai,9,441,432
2024-01-17,PROD017,Shenzhen,2,724,722
2024-01-18,PROD003,Beijing,4,1183,1179
2024-01-19,PROD013,Shenzhen,4,1109,1105
2024-01-20,PROD018,Shenzhen,10,1041,1031
2024-01-21,PROD004,Jilin,8,247,239
2024-01-22,PROD011,Jilin,2,406,404
2024-01-23,PROD014,Shenzhen,1,578,577
2024-01-24,PROD005,Shanghai,8,740,732
2024-01-25,PROD020,Beijing,10,949,939
2024-01-26,PROD004,Jilin,2,239,237
2024-01-27,PROD001,Shenzhen,6,535,529
2024-01-28,PROD010,Jilin,1,339,338
2024-01-29,PROD007,Shanghai,1,515,514
2024-01-30,PROD001,Beijing,9,232,223
2024-01-31,PROD019,Jilin,5,794,789
2024-02-01,PROD017,Jilin,6,1037,1031
2024-02-02,PROD005,Beijing,1,606,605
2024-02-03,PROD004,Beijing,5,615,610
2024-02-04,PROD007,Guangzhou,3,905,902
2024-02-05,PROD011,Jilin,3,404,401
2024-02-06,PROD006,Shenzhen,5,319,314
2024-02-07,PROD002,Shanghai,1,432,431
2024-02-08,PROD018,Jilin,3,1264,1261
2024-02-09,PROD010,Shanghai,5,544,539
2024-02-10,PROD010,Jilin,1,338,337
2024-02-11,PROD015,Shanghai,2,349,347
2024-02-12,PROD008,Jilin,2,539,537
2024-02-13,PROD020,Shanghai,6,331,325
2024-02-14,PROD001,Shenzhen,7,529,522
2024-02-15,PROD002,Beijing,7,830,823
2024-02-16,PROD005,Shenzhen,3,557,554
2024-02-17,PROD016,Guangzhou,5,316,311
2024-02-18,PROD014,Beijing,10,462,452
2024-02-19,PROD019,Beijing,3,564,561
2024-02-20,PROD012,Guangzhou,1,341,340
2024-02-21,PROD016,Shenzhen,8,322,314
2024-02-22,PROD013,Shanghai,5,918,913
2024-02-23,PROD018,Beijing,6,811,805
2024-02-24,PROD019,Beijing,3,561,558
2024-02-25,PROD010,Shenzhen,9,810,801
2024-02-26,PROD001,Shanghai,6,916,910
2024-02-27,PROD016,Jilin,7,629,622
2024-02-28,PROD002,Jilin,9,812,803
2024-02-29,PROD017,Shenzhen,9,722,713
2024-03-01,PROD012,Guangzhou,1,340,339
2024-03-02,PROD016,Jilin,8,622,614
2024-03-03,PROD011,Shenzhen,2,853,851
2024-03-04,PROD011,Shanghai,10,508,498
2024-03-05,PROD003,Shenzhen,1,921,920
2024-03-06,PROD017,Jilin,3,1031,1028
2024-03-07,PROD016,Shenzhen,8,314,306
2024-03-08,PROD003,Shenzhen,5,920,915
2024-03-09,PROD020,Shenzhen,4,1055,1051
2024-03-10,PROD020,Shenzhen,9,1051,1042
2024-03-11,PROD008,Shanghai,1,333,332
2024-03-12,PROD015,Beijing,7,787,780
2024-03-13,PROD012,Shenzhen,10,237,227
2024-03-14,PROD018,Shenzhen,2,1031,1029
2024-03-15,PROD018,Shenzhen,4,1029,1025
2024-03-16,PROD006,Shenzhen,10,314,304
2024-03-17,PROD012,Jilin,9,793,784
2024-03-18,PROD018,Shanghai,7,786,779
2024-03-19,PROD005,Beijing,1,605,604
2024-03-20,PROD016,Guangzhou,8,311,303
2024-03-21,PROD018,Beijing,10,805,795
2024-03-22,PROD007,Beijing,5,182,177
2024-03-23,PROD015,Shenzhen,1,697,696
2024-03-24,PROD002,Guangzhou,1,907,906
2024-03-25,PROD016,Beijing,6,1082,1076
2024-03-26,PROD007,Shenzhen,5,471,466
2024-03-27,PROD008,Jilin,3,537,534
2024-03-28,PROD016,Jilin,2,614,612
2024-03-29,PROD010,Shenzhen,4,801,797
2024-03-30,PROD010,Jilin,4,337,333
2024-03-31,PROD015,Guangzhou,5,635,630
2024-04-01,PROD015,Beijing,4,780,776
2024-04-02,PROD012,Shanghai,7,777,770
2024-04-03,PROD008,Guangzhou,4,1183,1179
2024-04-04,PROD011,Jilin,8,401,393
2024-04-05,PROD013,Shanghai,6,913,907
2024-04-06,PROD014,Shanghai,10,529,519
2024-04-07,PROD012,Beijing,8,980,972
2024-04-08,PROD017,Shenzhen,2,713,711
2024-04-09,PROD016,Shanghai,2,1062,1060
2024-04-10,PROD015,Shanghai,10,347,337
2024-04-11,PROD004,Shanghai,10,1170,1160
2024-04-12,PROD009,Beijing,9,426,417
2024-04-13,PROD011,Jilin,3,393,390
2024-04-14,PROD005,Beijing,4,604,600
2024-04-15,PROD005,Jilin,9,695,686
2024-04-16,PROD001,Beijing,4,223,219
2024-04-17,PROD020,Beijing,5,939,934
2024-04-18,PROD002,Shanghai,6,431,425
2024-04-19,PROD001,Shanghai,7,910,903
2024-04-20,PROD003,Jilin,7,1135,1128
2024-04-21,PROD006,Beijing,1,829,828
2024-04-22,PROD014,Guangzhou,6,294,288
2024-04-23,PROD015,Jilin,7,989,982
2024-04-24,PROD017,Shenzhen,7,711,704
2024-04-25,PROD008,Shenzhen,10,681,671
2024-04-26,PROD015,Jilin,2,982,980
2024-04-27,PROD001,Jilin,2,430,428
2024-04-28,PROD017,Shanghai,7,693,686
2024-04-29,PROD013,Shenzhen,9,1105,1096
2024-04-30,PROD005,Jilin,10,686,676
2024-05-01,PROD012,Shanghai,2,770,768
2024-05-02,PROD013,Beijing,9,1027,1018
2024-05-03,PROD004,Guangzhou,8,1189,1181
2024-05-04,PROD019,Shanghai,10,957,947
2024-05-05,PROD010,Guangzhou,6,1204,1198
2024-05-06,PROD014,Shenzhen,3,577,574
2024-05-07,PROD018,Shanghai,4,779,775
2024-05-08,PROD008,Guangzhou,7,1179,1172
2024-05-09,PROD017,Shanghai,8,686,678
2024-05-10,PROD003,Shenzhen,9,915,906
2024-05-11,PROD011,Shenzhen,6,851,845
2024-05-12,PROD005,Shenzhen,10,554,544
2024-05-13,PROD002,Shenzhen,6,1036,1030
2024-05-14,PROD002,Jilin,9,803,794
2024-05-15,PROD005,Beijing,1,600,599
2024-05-16,PROD014,Shenzhen,4,574,570
2024-05-17,PROD016,Beijing,10,1076,1066
2024-05-18,PROD010,Shanghai,4,539,535
2024-05-19,PROD020,Shanghai,9,325,316
2024-05-20,PROD005,Shenzhen,3,544,541
2024-05-21,PROD015,Beijing,1,776,775
2024-05-22,PROD010,Shanghai,10,535,525
2024-05-23,PROD019,Shenzhen,5,606,601
2024-05-24,PROD007,Shenzhen,8,466,458
2024-05-25,PROD004,Shanghai,7,1160,1153
2024-05-26,PROD009,Guangzhou,1,1096,1095
2024-05-27,PROD009,Jilin,6,332,326
2024-05-28,PROD008,Beijing,9,401,392
2024-05-29,PROD019,Jilin,5,789,784
2024-05-30,PROD009,Shenzhen,5,551,546
2024-05-31,PROD013,Jilin,6,790,784
2024-06-01,PROD018,Guangzhou,5,899,894
2024-06-02,PROD009,Shanghai,9,493,484
2024-06-03,PROD005,Guangzhou,2,405,403
2024-06-04,PROD014,Shenzhen,9,570,561
2024-06-05,PROD020,Shenzhen,6,1042,1036
2024-06-06,PROD006,Beijing,4,828,824
2024-06-07,PROD003,Shanghai,1,1005,1004
2024-06-08,PROD009,Beijing,5,417,412
2024-06-09,PROD004,Shanghai,1,1153,1152
2024-06-10,PROD016,Beijing,1,1066,1065
2024-06-11,PROD002,Jilin,5,794,789
2024-06-12,PROD002,Jilin,2,789,787
2024-06-13,PROD013,Shanghai,3,907,904
2024-06-14,PROD006,Shenzhen,6,304,298
2024-06-15,PROD014,Shenzhen,4,561,557
2024-06-16,PROD005,Beijing,10,599,589
2024-06-17,PROD002,Beijing,1,823,822
2024-06-18,PROD016,Beijing,5,1065,1060
2024-06-19,PROD010,Jilin,4,333,329
2024-06-20,PROD016,Shanghai,5,1060,1055
2024-06-21,PROD013,Shenzhen,8,1096,1088
2024-06-22,PROD005,Jilin,4,676,672
2024-06-23,PROD010,Beijing,8,1212,1204
2024-06-24,PROD011,Shanghai,3,498,495
2024-06-25,PROD003,Jilin,5,1128,1123
2024-06-26,PROD013,Beijing,5,1018,1013
2024-06-27,PROD015,Beijing,6,775,769
2024-06-28,PROD008,Shanghai,7,332,325
2024-06-29,PROD017,Beijing,1,1106,1105
2024-06-30,PROD014,Jilin,7,606,599
2024-07-01,PROD003,Beijing,10,1179,1169
2024-07-02,PROD013,Jilin,7,784,777
2024-07-03,PROD002,Shanghai,1,425,424
2024-07-04,PROD015,Guangzhou,3,630,627
2024-07-05,PROD020,Beijing,9,934,925
2024-07-06,PROD014,Beijing,8,452,444
2024-07-07,PROD002,Guangzhou,6,906,900
2024-07-08,PROD004,Beijing,1,610,609
2024-07-09,PROD008,Shenzhen,10,671,661
2024-07-10,PROD011,Shanghai,1,495,494
2024-07-11,PROD005,Jilin,5,672,667
2024-07-12,PROD015,Beijing,1,769,768
2024-07-13,PROD004,Beijing,9,609,600
2024-07-14,PROD015,Shanghai,8,337,329
2024-07-15,PROD009,Jilin,1,326,325
2024-07-16,PROD017,Guangzhou,6,338,332
2024-07-17,PROD013,Shenzhen,10,1088,1078
2024-07-18,PROD015,Jilin,5,980,975
2024-07-19,PROD015,Jilin,5,975,970
2024-07-20,PROD007,Shenzhen,9,458,449
2024-07-21,PROD020,Guangzhou,7,436,429
2024-07-22,PROD010,Shanghai,4,525,521
2024-07-23,PROD018,Shanghai,3,775,772
2024-07-24,PROD015,Shanghai,8,329,321
2024-07-25,PROD011,Shenzhen,6,845,839
2024-07-26,PROD018,Jilin,8,1261,1253
2024-07-27,PROD018,Shenzhen,8,1025,1017
2024-07-28,PROD009,Shanghai,4,484,480
2024-07-29,PROD006,Beijing,8,824,816
2024-07-30,PROD010,Beijing,8,1204,1196
2024-07-31,PROD020,Guangzhou,1,429,428
2024-08-01,PROD016,Jilin,6,612,606
2024-08-02,PROD013,Guangzhou,5,584,579
2024-08-03,PROD018,Shanghai,6,772,766
2024-08-04,PROD015,Shenzhen,10,696,686
2024-08-05,PROD009,Shenzhen,7,546,539
2024-08-06,PROD005,Jilin,2,667,665
2024-08-07,PROD019,Shanghai,2,947,945
2024-08-08,PROD007,Beijing,5,177,172
2024-08-09,PROD003,Shenzhen,2,906,904
2024-08-10,PROD012,Beijing,6,972,966
2024-08-11,PROD006,Shanghai,2,267,265
2024-08-12,PROD020,Jilin,1,1069,1068
2024-08-13,PROD002,Jilin,8,787,779
2024-08-14,PROD014,Guangzhou,4,288,284
2024-08-15,PROD010,Guangzhou,8,1198,1190
2024-08-16,PROD006,Jilin,6,749,743
2024-08-17,PROD014,Guangzhou,7,284,277
2024-08-18,PROD010,Beijing,7,1196,1189
2024-08-19,PROD017,Jilin,3,1028,1025
2024-08-20,PROD019,Shanghai,8,945,937
2024-08-21,PROD003,Guangzhou,8,946,938
2024-08-22,PROD015,Shanghai,1,321,320
2024-08-23,PROD002,Shenzhen,9,1030,1021
2024-08-24,PROD008,Jilin,8,534,526
2024-08-25,PROD002,Shenzhen,4,1021,1017
2024-08-26,PROD007,Beijing,6,172,166
2024-08-27,PROD013,Shanghai,3,904,901
2024-08-28,PROD009,Beijing,10,412,402
2024-08-29,PROD011,Shenzhen,10,839,829
2024-08-30,PROD001,Jilin,5,428,423
2024-08-31,PROD013,Jilin,10,777,767
2024-09-01,PROD016,Shenzhen,10,306,296
2024-09-02,PROD012,Shanghai,5,768,763
2024-09-03,PROD002,Guangzhou,8,900,892
2024-09-04,PROD001,Beijing,5,219,214
2024-09-05,PROD010,Jilin,2,329,327
2024-09-06,PROD005,Beijing,9,589,580
2024-09-07,PROD007,Beijing,1,166,165
2024-09-08,PROD015,Shenzhen,5,686,681
2024-09-09,PROD019,Guangzhou,8,1073,1065
2024-09-10,PROD020,Guangzhou,7,428,421
2024-09-11,PROD019,Shenzhen,8,601,593
2024-09-12,PROD016,Guangzhou,5,303,298
2024-09-13,PROD010,Beijing,7,1189,1182
2024-09-14,PROD005,Beijing,9,580,571
2024-09-15,PROD007,Beijing,9,165,156
2024-09-16,PROD014,Jilin,6,599,593
2024-09-17,PROD013,Shanghai,3,901,898
2024-09-18,PROD020,Jilin,8,1068,1060
2024-09-19,PROD003,Shenzhen,5,904,899
2024-09-20,PROD006,Jilin,8,743,735
2024-09-21,PROD013,Shanghai,2,898,896
2024-09-22,PROD005,Shenzhen,10,541,531
2024-09-23,PROD008,Guangzhou,8,1172,1164
2024-09-24,PROD018,Beijing,8,795,787
2024-09-25,PROD013,Shanghai,2,896,894
2024-09-26,PROD006,Guangzhou,1,1105,1104
2024-09-27,PROD011,Jilin,1,390,389
2024-09-28,PROD001,Guangzhou,1,1066,1065
2024-09-29,PROD003,Guangzhou,10,938,928
2024-09-30,PROD012,Beijing,1,966,965
2024-10-01,PROD020,Shenzhen,6,1036,1030
2024-10-02,PROD001,Shenzhen,1,522,521
2024-10-03,PROD014,Shanghai,8,519,511
2024-10-04,PROD013,Shenzhen,8,1078,1070
2024-10-05,PROD016,Shenzhen,4,296,292
2024-10-06,PROD004,Shenzhen,5,408,403
2024-10-07,PROD010,Beijing,6,1182,1176
2024-10-08,PROD015,Shanghai,7,320,313
2024-10-09,PROD003,Beijing,6,1169,1163
2024-10-10,PROD019,Shenzhen,8,593,585
2024-10-11,PROD009,Guangzhou,5,1095,1090
2024-10-12,PROD012,Shenzhen,9,227,218
2024-10-13,PROD008,Guangzhou,10,1164,1154
2024-10-14,PROD018,Shanghai,9,766,757
2024-10-15,PROD002,Shenzhen,2,1017,1015
2024-10-16,PROD010,Shenzhen,7,797,790
2024-10-17,PROD010,Jilin,5,327,322
2024-10-18,PROD013,Beijing,1,1013,1012
2024-10-19,PROD008,Shanghai,8,325,317
2024-10-20,PROD003,Shanghai,10,1004,994
2024-10-21,PROD011,Shanghai,9,494,485
2024-10-22,PROD008,Shenzhen,8,661,653
2024-10-23,PROD006,Shanghai,8,265,257
2024-10-24,PROD009,Shenzhen,3,539,536
2024-10-25,PROD019,Shanghai,6,937,931
2024-10-26,PROD004,Beijing,7,600,593
2024-10-27,PROD016,Beijing,4,1060,1056
2024-10-28,PROD001,Shanghai,6,903,897
2024-10-29,PROD015,Jilin,5,970,965
2024-10-30,PROD007,Jilin,1,273,272
2024-10-31,PROD018,Beijing,8,787,779
2024-11-01,PROD003,Jilin,4,1123,1119
2024-11-02,PROD012,Beijing,2,965,963
2024-11-03,PROD002,Shanghai,3,424,421
2024-11-04,PROD013,Shanghai,7,894,887
2024-11-05,PROD010,Shenzhen,10,790,780
2024-11-06,PROD004,Shanghai,1,1152,1151
2024-11-07,PROD008,Shanghai,4,317,313
2024-11-08,PROD020,Guangzhou,4,421,417
2024-11-09,PROD013,Jilin,9,767,758
2024-11-10,PROD015,Guangzhou,9,627,618
2024-11-11,PROD010,Guangzhou,10,1190,1180
2024-11-12,PROD005,Shenzhen,5,531,526
2024-11-13,PROD003,Guangzhou,6,928,922
2024-11-14,PROD010,Guangzhou,9,1180,1171
2024-11-15,PROD007,Beijing,9,156,147
2024-11-16,PROD016,Beijing,7,1056,1049
2024-11-17,PROD013,Shenzhen,4,1070,1066
2024-11-18,PROD005,Shanghai,7,732,725
2024-11-19,PROD003,Jilin,3,1119,1116
2024-11-20,PROD003,Jilin,6,1116,1110
2024-11-21,PROD011,Shenzhen,9,829,820
2024-11-22,PROD013,Guangzhou,8,579,571
2024-11-23,PROD012,Jilin,2,784,782
2024-11-24,PROD002,Jilin,8,779,771
2024-11-25,PROD012,Beijing,1,963,962
2024-11-26,PROD003,Beijing,7,1163,1156
2024-11-27,PROD002,Jilin,10,771,761
2024-11-28,PROD012,Shanghai,3,763,760
2024-11-29,PROD009,Shenzhen,1,536,535
2024-11-30,PROD001,Shanghai,8,897,889
2024-12-01,PROD016,Beijing,10,1049,1039
2024-12-02,PROD006,Shenzhen,4,298,294
2024-12-03,PROD009,Guangzhou,8,1090,1082
2024-12-04,PROD002,Jilin,10,761,751
2024-12-05,PROD010,Jilin,5,322,317
2024-12-06,PROD014,Beijing,3,444,441
2024-12-07,PROD017,Guangzhou,4,332,328
2024-12-08,PROD012,Beijing,2,962,960
2024-12-09,PROD002,Guangzhou,4,892,888
2024-12-10,PROD017,Guangzhou,7,328,321
2024-12-11,PROD006,Guangzhou,3,1104,1101
2024-12-12,PROD005,Beijing,1,571,570
2024-12-13,PROD015,Guangzhou,10,618,608
2024-12-14,PROD012,Guangzhou,9,339,330
2024-12-15,PROD008,Beijing,3,392,389
2024-12-16,PROD010,Jilin,3,317,314
2024-12-17,PROD017,Jilin,8,1025,1017
2024-12-18,PROD001,Jilin,9,423,414
2024-12-19,PROD010,Shanghai,3,521,518
2024-12-20,PROD006,Jilin,10,735,725
2024-12-21,PROD001,Beijing,4,214,210
2024-12-22,PROD018,Beijing,9,779,770
2024-12-23,PROD011,Shenzhen,4,820,816
2024-12-24,PROD015,Jilin,8,965,957
2024-12-25,PROD016,Shanghai,10,1055,1045
2024-12-26,PROD003,Shanghai,3,994,991
2024-12-27,PROD001,Jilin,4,414,410
2024-12-28,PROD017,Shanghai,2,678,676
2024-12-29,PROD002,Shenzhen,4,1015,1011
2024-12-30,PROD007,Guangzhou,4,902,898
2024-01-01,PROD019,Shenzhen,3,585,582
2024-01-02,PROD015,Jilin,7,957,950
2024-01-03,PROD012,Beijing,8,960,952
2024-01-04,PROD009,Beijing,6,402,396
2024-01-05,PROD006,Shanghai,1,257,256
2024-01-06,PROD017,Shenzhen,9,704,695
2024-01-07,PROD005,Shenzhen,2,526,524
2024-01-08,PROD015,Beijing,6,768,762
2024-01-09,PROD004,Beijing,6,593,587
2024-01-10,PROD002,Guangzhou,7,888,881
2024-01-11,PROD005,Shenzhen,1,524,523
2024-01-12,PROD018,Jilin,7,1253,1246
2024-01-13,PROD001,Guangzhou,8,1065,1057
2024-01-14,PROD003,Shanghai,6,991,985
2024-01-15,PROD005,Jilin,1,665,664
2024-01-16,PROD018,Shanghai,1,757,756
2024-01-17,PROD011,Shanghai,6,485,479
2024-01-18,PROD003,Shanghai,2,985,983
2024-01-19,PROD016,Shanghai,3,1045,1042
2024-01-20,PROD020,Jilin,8,1060,1052
2024-01-21,PROD018,Guangzhou,1,894,893
2024-01-22,PROD003,Shanghai,8,983,975
2024-01-23,PROD007,Beijing,5,147,142
2024-01-24,PROD017,Guangzhou,9,321,312
2024-01-25,PROD007,Beijing,2,142,140
2024-01-26,PROD006,Jilin,7,725,718
2024-01-27,PROD019,Shanghai,3,931,928
2024-01-28,PROD015,Guangzhou,10,608,598
2024-01-29,PROD005,Shanghai,4,725,721
2024-01-30,PROD015,Jilin,10,950,940
2024-01-31,PROD002,Beijing,6,822,816
2024-02-01,PROD010,Jilin,10,314,304
2024-02-02,PROD005,Shenzhen,7,523,516
2024-02-03,PROD009,Jilin,10,325,315
2024-02-04,PROD002,Shanghai,3,421,418
2024-02-05,PROD008,Beijing,6,389,383
2024-02-06,PROD004,Guangzhou,10,1181,1171
2024-02-07,PROD005,Jilin,7,664,657
2024-02-08,PROD003,Jilin,6,1110,1104
2024-02-09,PROD015,Beijing,8,762,754
2024-02-10,PROD004,Shanghai,10,1151,1141
2024-02-11,PROD007,Shenzhen,10,449,439
2024-02-12,PROD004,Jilin,3,237,234
2024-02-13,PROD004,Shanghai,2,1141,1139
2024-02-14,PROD016,Shenzhen,6,292,286
2024-02-15,PROD020,Beijing,7,925,918
2024-02-16,PROD011,Jilin,6,389,383
2024-02-17,PROD020,Shenzhen,7,1030,1023
2024-02-18,PROD015,Shanghai,1,313,312
2024-02-19,PROD016,Shenzhen,6,286,280
2024-02-20,PROD020,Shenzhen,9,1023,1014
2024-02-21,PROD002,Guangzhou,10,881,871
2024-02-22,PROD004,Guangzhou,9,1171,1162
2024-02-23,PROD003,Shanghai,1,975,974
2024-02-24,PROD007,Shenzhen,7,439,432
2024-02-25,PROD020,Jilin,9,1052,1043
2024-02-26,PROD017,Shanghai,10,676,666
2024-02-27,PROD016,Shanghai,6,1042,1036
2024-02-28,PROD011,Beijing,4,1278,1274
2024-02-29,PROD019,Shanghai,4,928,924
2024-03-01,PROD020,Jilin,1,1043,1042
2024-03-02,PROD019,Guangzhou,5,1065,1060
2024-03-03,PROD014,Beijing,3,441,438
2024-03-04,PROD020,Shanghai,7,316,309
2024-03-05,PROD005,Guangzhou,7,403,396
2024-03-06,PROD002,Shanghai,10,418,408
2024-03-07,PROD016,Jilin,6,606,600
2024-03-08,PROD016,Shenzhen,8,280,272
2024-03-09,PROD008,Shenzhen,5,653,648
2024-03-10,PROD017,Jilin,10,1017,1007
2024-03-11,PROD010,Shenzhen,6,780,774
2024-03-12,PROD012,Beijing,10,952,942
2024-03-13,PROD011,Shanghai,7,479,472
2024-03-14,PROD006,Jilin,4,718,714
2024-03-15,PROD007,Shanghai,8,514,506
2024-03-16,PROD010,Beijing,7,1176,1169
2024-03-17,PROD013,Jilin,5,758,753
2024-03-18,PROD019,Beijing,10,558,548
2024-03-19,PROD011,Jilin,7,383,376
2024-03-20,PROD006,Shenzhen,7,294,287
2024-03-21,PROD003,Shanghai,6,974,968
2024-03-22,PROD020,Shenzhen,8,1014,1006
2024-03-23,PROD010,Shanghai,1,518,517
2024-03-24,PROD001,Beijing,2,210,208
2024-03-25,PROD004,Shanghai,9,1139,1130
2024-03-26,PROD019,Shanghai,6,924,918
2024-03-27,PROD017,Guangzhou,2,312,310
2024-03-28,PROD007,Guangzhou,6,898,892
2024-03-29,PROD012,Guangzhou,2,330,328
2024-03-30,PROD013,Shenzhen,2,1066,1064
2024-03-31,PROD017,Jilin,4,1007,1003
2024-04-01,PROD004,Beijing,3,587,584
2024-04-02,PROD004,Jilin,5,234,229
2024-04-03,PROD011,Shenzhen,3,816,813
2024-04-04,PROD009,Beijing,8,396,388
2024-04-05,PROD007,Guangzhou,2,892,890
2024-04-06,PROD011,Jilin,8,376,368
2024-04-07,PROD002,Jilin,5,751,746
2024-04-08,PROD019,Shenzhen,8,582,574
2024-04-09,PROD013,Jilin,1,753,752
2024-04-10,PROD005,Shanghai,2,721,719
2024-04-11,PROD003,Beijing,1,1156,1155
2024-04-12,PROD012,Guangzhou,7,328,321
2024-04-13,PROD004,Guangzhou,6,1162,1156
2024-04-14,PROD014,Guangzhou,3,277,274
2024-04-15,PROD006,Shanghai,3,256,253
2024-04-16,PROD013,Shenzhen,8,1064,1056
2024-04-17,PROD015,Beijing,9,754,745
2024-04-18,PROD004,Jilin,3,229,226
2024-04-19,PROD001,Shanghai,3,889,886
2024-04-20,PROD018,Guangzhou,2,893,891
2024-04-21,PROD019,Guangzhou,2,1060,1058
2024-04-22,PROD016,Beijing,3,1039,1036
2024-04-23,PROD014,Shenzhen,10,557,547
2024-04-24,PROD016,Guangzhou,10,298,288
2024-04-25,PROD015,Jilin,7,940,933
2024-04-26,PROD015,Jilin,10,933,923
2024-04-27,PROD009,Shenzhen,10,535,525
2024-04-28,PROD007,Guangzhou,5,890,885
2024-04-29,PROD010,Beijing,6,1169,1163
2024-04-30,PROD013,Shenzhen,1,1056,1055
2024-05-01,PROD018,Shenzhen,6,1017,1011
2024-05-02,PROD003,Jilin,3,1104,1101
2024-05-03,PROD010,Shanghai,9,517,508
2024-05-04,PROD013,Shanghai,9,887,878
2024-05-05,PROD001,Jilin,1,410,409
2024-05-06,PROD007,Guangzhou,10,885,875
2024-05-07,PROD019,Beijing,4,548,544
2024-05-08,PROD003,Guangzhou,1,922,921
2024-05-09,PROD008,Shenzhen,8,648,640
2024-05-10,PROD003,Guangzhou,7,921,914
2024-05-11,PROD002,Guangzhou,9,871,862
2024-05-12,PROD002,Beijing,7,816,809
2024-05-13,PROD004,Beijing,1,584,583
2024-05-14,PROD007,Jilin,4,272,268
2024-05-15,PROD002,Beijing,3,809,806
2024-05-16,PROD002,Shanghai,1,408,407
2024-05-17,PROD008,Jilin,8,526,518
2024-05-18,PROD017,Shanghai,9,666,657
2024-05-19,PROD016,Beijing,10,1036,1026
2024-05-20,PROD009,Jilin,5,315,310
2024-05-21,PROD010,Beijing,4,1163,1159
2024-05-22,PROD020,Shanghai,1,309,308
2024-05-23,PROD013,Guangzhou,5,571,566
2024-05-24,PROD014,Guangzhou,9,274,265
2024-05-25,PROD004,Guangzhou,2,1156,1154
2024-05-26,PROD018,Beijing,3,770,767
2024-05-27,PROD003,Beijing,10,1155,1145
2024-05-28,PROD007,Shenzhen,2,432,430
2024-05-29,PROD020,Beijing,1,918,917
2024-05-30,PROD009,Jilin,10,310,300
2024-05-31,PROD004,Shenzhen,10,403,393
2024-06-01,PROD002,Guangzhou,3,862,859
2024-06-02,PROD004,Beijing,7,583,576
2024-06-03,PROD001,Shenzhen,9,521,512
2024-06-04,PROD003,Jilin,8,1101,1093
2024-06-05,PROD011,Beijing,5,1274,1269
2024-06-06,PROD015,Beijing,7,745,738
2024-06-07,PROD013,Beijing,8,1012,1004
2024-06-08,PROD003,Guangzhou,6,914,908
2024-06-09,PROD012,Jilin,8,782,774
2024-06-10,PROD018,Beijing,2,767,765
2024-06-11,PROD016,Shenzhen,9,272,263
2024-06-12,PROD012,Shenzhen,8,218,210
2024-06-13,PROD002,Guangzhou,3,859,856
2024-06-14,PROD004,Jilin,4,226,222
2024-06-15,PROD011,Shanghai,2,472,470
2024-06-16,PROD007,Jilin,9,268,259
2024-06-17,PROD008,Shenzhen,4,640,636
2024-06-18,PROD004,Guangzhou,2,1154,1152
2024-06-19,PROD001,Guangzhou,1,1057,1056
2024-06-20,PROD019,Guangzhou,9,1058,1049
2024-06-21,PROD020,Shenzhen,4,1006,1002
2024-06-22,PROD011,Jilin,1,368,367
2024-06-23,PROD011,Jilin,9,367,358
2024-06-24,PROD011,Beijing,2,1269,1267
2024-06-25,PROD002,Jilin,8,746,738
2024-06-26,PROD004,Shanghai,1,1130,1129
2024-06-27,PROD016,Shanghai,2,1036,1034
2024-06-28,PROD004,Beijing,8,576,568
2024-06-29,PROD001,Shanghai,10,886,876
2024-06-30,PROD015,Jilin,1,923,922
2024-07-01,PROD007,Jilin,2,259,257
2024-07-02,PROD006,Shanghai,8,253,245
2024-07-03,PROD006,Jilin,10,714,704
2024-07-04,PROD002,Shanghai,3,407,404
2024-07-05,PROD009,Shenzhen,10,525,515
2024-07-06,PROD013,Shanghai,7,878,871
2024-07-07,PROD011,Jilin,2,358,356
2024-07-08,PROD001,Beijing,2,208,206
2024-07-09,PROD004,Guangzhou,9,1152,1143
2024-07-10,PROD015,Shanghai,8,312,304
2024-07-11,PROD016,Jilin,1,600,599
2024-07-12,PROD011,Shanghai,1,470,469
2024-07-13,PROD015,Shanghai,6,304,298
2024-07-14,PROD005,Beijing,3,570,567
2024-07-15,PROD002,Jilin,7,738,731
2024-07-16,PROD017,Shanghai,8,657,649
2024-07-17,PROD008,Beijing,1,383,382
2024-07-18,PROD012,Jilin,2,774,772
2024-07-19,PROD004,Shenzhen,7,393,386
2024-07-20,PROD004,Shenzhen,3,386,383
2024-07-21,PROD020,Shenzhen,1,1002,1001
2024-07-22,PROD006,Jilin,3,704,701
2024-07-23,PROD004,Shenzhen,2,383,381
2024-07-24,PROD010,Shanghai,9,508,499
2024-07-25,PROD010,Jilin,8,304,296
2024-07-26,PROD018,Shanghai,6,756,750
2024-07-27,PROD003,Guangzhou,4,908,904
2024-07-28,PROD020,Shenzhen,2,1001,999
2024-07-29,PROD001,Shenzhen,8,512,504
2024-07-30,PROD016,Beijing,2,1026,1024
2024-07-31,PROD015,Beijing,4,738,734
2024-08-01,PROD002,Shenzhen,6,1011,1005
2024-08-02,PROD011,Guangzhou,8,648,640
2024-08-03,PROD017,Guangzhou,10,310,300
2024-08-04,PROD019,Shenzhen,1,574,573
2024-08-05,PROD012,Shenzhen,4,210,206
2024-08-06,PROD017,Guangzhou,10,300,290
2024-08-07,PROD006,Shenzhen,2,287,285
2024-08-08,PROD020,Beijing,5,917,912
2024-08-09,PROD017,Jilin,8,1003,995
2024-08-10,PROD017,Guangzhou,4,290,286
2024-08-11,PROD009,Jilin,10,300,290
2024-08-12,PROD007,Guangzhou,8,875,867
2024-08-13,PROD013,Guangzhou,5,566,561
2024-08-14,PROD004,Guangzhou,5,1143,1138
2024-08-15,PROD020,Jilin,1,1042,1041
2024-08-16,PROD001,Shanghai,10,876,866
2024-08-17,PROD002,Jilin,2,731,729
2024-08-18,PROD020,Shenzhen,9,999,990
2024-08-19,PROD015,Shanghai,5,298,293
2024-08-20,PROD020,Beijing,7,912,905
2024-08-21,PROD016,Beijing,4,1024,1020
2024-08-22,PROD020,Guangzhou,7,417,410
2024-08-23,PROD003,Beijing,8,1145,1137
2024-08-24,PROD017,Shanghai,4,649,645
2024-08-25,PROD011,Shenzhen,2,813,811
2024-08-26,PROD017,Jilin,1,995,994
2024-08-27,PROD016,Beijing,4,1020,1016
2024-08-28,PROD001,Guangzhou,4,1056,1052
2024-08-29,PROD010,Shanghai,7,499,492
2024-08-30,PROD014,Jilin,9,593,584
2024-08-31,PROD008,Guangzhou,4,1154,1150
2024-09-01,PROD005,Guangzhou,8,396,388
2024-09-02,PROD012,Jilin,2,772,770
2024-09-03,PROD007,Jilin,2,257,255
2024-09-04,PROD004,Jilin,5,222,217
2024-09-05,PROD017,Guangzhou,8,286,278
2024-09-06,PROD006,Shenzhen,1,285,284
2024-09-07,PROD015,Shenzhen,4,681,677
2024-09-08,PROD014,Jilin,10,584,574
2024-09-09,PROD006,Jilin,2,701,699
2024-09-10,PROD008,Guangzhou,4,1150,1146
2024-09-11,PROD019,Shanghai,2,918,916
2024-09-12,PROD013,Guangzhou,8,561,553
2024-09-13,PROD004,Beijing,10,568,558
2024-09-14,PROD002,Shenzhen,5,1005,1000
2024-09-15,PROD001,Guangzhou,7,1052,1045
2024-09-16,PROD012,Shanghai,9,760,751
2024-09-17,PROD003,Beijing,8,1137,1129
2024-09-18,PROD020,Jilin,10,1041,1031
2024-09-19,PROD001,Shanghai,1,866,865
2024-09-20,PROD014,Beijing,8,438,430
2024-09-21,PROD007,Jilin,5,255,250
2024-09-22,PROD015,Shenzhen,5,677,672
2024-09-23,PROD009,Jilin,9,290,281
2024-09-24,PROD010,Guangzhou,6,1171,1165
2024-09-25,PROD015,Beijing,9,734,725
2024-09-26,PROD016,Shenzhen,9,263,254
2024-09-27,PROD004,Guangzhou,1,1138,1137
2024-09-28,PROD018,Shanghai,10,750,740
2024-09-29,PROD013,Guangzhou,4,553,549
2024-09-30,PROD019,Shenzhen,5,573,568
2024-10-01,PROD013,Shenzhen,10,1055,1045
2024-10-02,PROD012,Beijing,9,942,933
2024-10-03,PROD014,Jilin,1,574,573
2024-10-04,PROD008,Shenzhen,8,636,628
2024-10-05,PROD005,Shanghai,3,719,716
2024-10-06,PROD004,Shanghai,5,1129,1124
2024-10-07,PROD007,Guangzhou,4,867,863
2024-10-08,PROD017,Guangzhou,4,278,274
2024-10-09,PROD019,Shenzhen,1,568,567
2024-10-10,PROD020,Guangzhou,9,410,401
2024-10-11,PROD014,Shenzhen,10,547,537
2024-10-12,PROD011,Jilin,3,356,353
2024-10-13,PROD004,Beijing,3,558,555
2024-10-14,PROD020,Beijing,9,905,896
2024-10-15,PROD011,Shanghai,7,469,462
2024-10-16,PROD007,Guangzhou,1,863,862
2024-10-17,PROD006,Beijing,3,816,813
2024-10-18,PROD014,Beijing,10,430,420
2024-10-19,PROD007,Shanghai,6,506,500
2024-10-20,PROD019,Shenzhen,7,567,560
2024-10-21,PROD013,Beijing,2,1004,1002
2024-10-22,PROD003,Beijing,4,1129,1125
2024-10-23,PROD018,Beijing,5,765,760
2024-10-24,PROD002,Guangzhou,2,856,854
2024-10-25,PROD019,Beijing,9,544,535
2024-10-26,PROD005,Shanghai,4,716,712
2024-10-27,PROD003,Jilin,7,1093,1086
2024-10-28,PROD016,Jilin,7,599,592
2024-10-29,PROD001,Shenzhen,3,504,501
2024-10-30,PROD020,Guangzhou,7,401,394
2024-10-31,PROD020,Guangzhou,8,394,386
2024-11-01,PROD004,Beijing,10,555,545
2024-11-02,PROD013,Shanghai,10,871,861
2024-11-03,PROD003,Guangzhou,6,904,898
2024-11-04,PROD001,Guangzhou,6,1045,1039
2024-11-05,PROD004,Jilin,2,217,215
2024-11-06,PROD004,Jilin,7,215,208
2024-11-07,PROD005,Beijing,7,567,560
2024-11-08,PROD020,Shenzhen,2,990,988
2024-11-09,PROD010,Shenzhen,4,774,770
2024-11-10,PROD006,Shanghai,3,245,242
2024-11-11,PROD004,Shanghai,9,1124,1115
2024-11-12,PROD010,Beijing,2,1159,1157
2024-11-13,PROD009,Jilin,6,281,275
2024-11-14,PROD012,Beijing,8,933,925
2024-11-15,PROD010,Guangzhou,5,1165,1160
2024-11-16,PROD015,Beijing,5,725,720
2024-11-17,PROD012,Shenzhen,5,206,201
2024-11-18,PROD007,Shanghai,1,500,499
2024-11-19,PROD008,Shenzhen,4,628,624
2024-11-20,PROD015,Jilin,5,922,917
2024-11-21,PROD010,Beijing,10,1157,1147
2024-11-22,PROD005,Jilin,6,657,651
2024-11-23,PROD015,Beijing,8,720,712
2024-11-24,PROD007,Shenzhen,10,430,420
2024-11-25,PROD013,Jilin,6,752,746
2024-11-26,PROD019,Beijing,4,535,531
2024-11-27,PROD006,Beijing,8,813,805
2024-11-28,PROD005,Guangzhou,5,388,383
2024-11-29,PROD017,Jilin,7,994,987
2024-11-30,PROD015,Jilin,6,917,911
2024-12-01,PROD015,Shanghai,9,293,284
2024-12-02,PROD004,Beijing,1,545,544
2024-12-03,PROD019,Jilin,10,784,774
2024-12-04,PROD012,Shanghai,5,751,746
2024-12-05,PROD016,Shanghai,2,1034,1032
2024-12-06,PROD014,Jilin,7,573,566
2024-12-07,PROD002,Shenzhen,2,1000,998
2024-12-08,PROD009,Guangzhou,1,1082,1081
2024-12-09,PROD006,Guangzhou,2,1101,1099
2024-12-10,PROD018,Guangzhou,7,891,884
2024-12-11,PROD003,Guangzhou,3,898,895
2024-12-12,PROD002,Beijing,10,806,796
2024-12-13,PROD002,Guangzhou,2,854,852
2024-12-14,PROD010,Shenzhen,7,770,763
2024-12-15,PROD014,Jilin,8,566,558
2024-12-16,PROD002,Jilin,5,729,724
2024-12-17,PROD008,Shenzhen,10,624,614
2024-12-18,PROD003,Shenzhen,6,899,893
2024-12-19,PROD006,Shenzhen,4,284,280
2024-12-20,PROD011,Shanghai,6,462,456
2024-12-21,PROD002,Jilin,3,724,721
2024-12-22,PROD020,Shanghai,7,308,301
2024-12-23,PROD007,Shenzhen,2,420,418
2024-12-24,PROD013,Beijing,1,1002,1001
2024-12-25,PROD010,Shenzhen,9,763,754
2024-12-26,PROD018,Beijing,8,760,752
2024-12-27,PROD019,Jilin,6,774,768
2024-12-28,PROD013,Shanghai,10,861,851
2024-12-29,PROD017,Shanghai,1,645,644
2024-12-30,PROD012,Jilin,10,770,760
2024-01-01,PROD002,Guangzhou,2,852,850
2024-01-02,PROD003,Guangzhou,8,895,887
2024-01-03,PROD014,Beijing,3,420,417
2024-01-04,PROD003,Jilin,7,1086,1079
2024-01-05,PROD015,Shenzhen,6,672,666
2024-01-06,PROD011,Shenzhen,10,811,801
2024-01-07,PROD001,Shanghai,8,865,857
2024-01-08,PROD007,Shanghai,10,499,489
2024-01-09,PROD001,Jilin,5,409,404
2024-01-10,PROD005,Guangzhou,10,383,373
2024-01-11,PROD020,Shanghai,3,301,298
2024-01-12,PROD019,Guangzhou,1,1049,1048
2024-01-13,PROD013,Jilin,10,746,736
2024-01-14,PROD006,Jilin,8,699,691
2024-01-15,PROD015,Shenzhen,5,666,661
2024-01-16,PROD018,Shenzhen,9,1011,1002
2024-01-17,PROD008,Shenzhen,9,614,605
2024-01-18,PROD001,Guangzhou,1,1039,1038
2024-01-19,PROD001,Jilin,3,404,401
2024-01-20,PROD012,Guangzhou,9,321,312
2024-01-21,PROD003,Jilin,8,1079,1071
2024-01-22,PROD006,Beijing,4,805,801
2024-01-23,PROD004,Beijing,1,544,543
2024-01-24,PROD006,Jilin,8,691,683
2024-01-25,PROD006,Beijing,5,801,796
2024-01-26,PROD019,Guangzhou,5,1048,1043
2024-01-27,PROD011,Guangzhou,7,640,633
2024-01-28,PROD019,Shenzhen,9,560,551
2024-01-29,PROD006,Jilin,2,683,681
2024-01-30,PROD004,Shanghai,3,1115,1112
2024-01-31,PROD002,Guangzhou,6,850,844
2024-02-01,PROD010,Jilin,2,296,294
2024-02-02,PROD005,Beijing,10,560,550
2024-02-03,PROD006,Jilin,5,681,676
2024-02-04,PROD008,Guangzhou,4,1146,1142
2024-02-05,PROD010,Guangzhou,1,1160,1159
2024-02-06,PROD008,Jilin,9,518,509
2024-02-07,PROD005,Beijing,9,550,541
2024-02-08,PROD013,Shenzhen,8,1045,1037
2024-02-09,PROD019,Jilin,3,768,765
2024-02-10,PROD015,Shanghai,1,284,283
2024-02-11,PROD015,Shenzhen,2,661,659
2024-02-12,PROD014,Beijing,2,417,415
2024-02-13,PROD016,Beijing,4,1016,1012
2024-02-14,PROD020,Beijing,5,896,891
2024-02-15,PROD006,Shenzhen,7,280,273
2024-02-16,PROD015,Shenzhen,3,659,656
2024-02-17,PROD009,Beijing,3,388,385
2024-02-18,PROD013,Jilin,10,736,726
2024-02-19,PROD018,Beijing,1,752,751
2024-02-20,PROD011,Shanghai,8,456,448
2024-02-21,PROD017,Shenzhen,8,695,687
2024-02-22,PROD007,Shanghai,10,489,479
2024-02-23,PROD005,Shenzhen,4,516,512
2024-02-24,PROD005,Guangzhou,5,373,368
2024-02-25,PROD020,Beijing,3,891,888
2024-02-26,PROD013,Shenzhen,9,1037,1028
2024-02-27,PROD011,Guangzhou,4,633,629
2024-02-28,PROD011,Shenzhen,2,801,799
2024-02-29,PROD001,Jilin,10,401,391
2024-03-01,PROD011,Shanghai,4,448,444
2024-03-02,PROD016,Jilin,10,592,582
2024-03-03,PROD016,Shenzhen,4,254,250
2024-03-04,PROD014,Shanghai,8,511,503
2024-03-05,PROD019,Shenzhen,9,551,542
2024-03-06,PROD010,Shenzhen,3,754,751
2024-03-07,PROD013,Shanghai,4,851,847
2024-03-08,PROD010,Beijing,6,1147,1141
2024-03-09,PROD004,Shenzhen,8,381,373
2024-03-10,PROD017,Beijing,8,1105,1097
2024-03-11,PROD017,Beijing,8,1097,1089
2024-03-12,PROD004,Guangzhou,9,1137,1128
2024-03-13,PROD004,Shenzhen,7,373,366
2024-03-14,PROD015,Jilin,1,911,910
2024-03-15,PROD010,Guangzhou,4,1159,1155
2024-03-16,PROD016,Guangzhou,6,288,282
2024-03-17,PROD012,Guangzhou,2,312,310
2024-03-18,PROD006,Shanghai,6,242,236
2024-03-19,PROD005,Shenzhen,3,512,509
2024-03-20,PROD009,Guangzhou,3,1081,1078
2024-03-21,PROD001,Shenzhen,10,501,491
2024-03-22,PROD014,Beijing,5,415,410
2024-03-23,PROD008,Shenzhen,9,605,596
2024-03-24,PROD010,Shanghai,6,492,486
2024-03-25,PROD004,Beijing,3,543,540
2024-03-26,PROD015,Shenzhen,10,656,646
2024-03-27,PROD014,Jilin,3,558,555
2024-03-28,PROD016,Jilin,3,582,579
2024-03-29,PROD016,Guangzhou,1,282,281
2024-03-30,PROD011,Jilin,9,353,344
2024-03-31,PROD006,Guangzhou,7,1099,1092
2024-04-01,PROD020,Shenzhen,9,988,979
2024-04-02,PROD017,Shenzhen,3,687,684
2024-04-03,PROD018,Jilin,10,1246,1236
2024-04-04,PROD005,Guangzhou,2,368,366
2024-04-05,PROD001,Shanghai,10,857,847
2024-04-06,PROD010,Beijing,10,1141,1131
2024-04-07,PROD014,Shenzhen,1,537,536
2024-04-08,PROD008,Jilin,10,509,499
2024-04-09,PROD006,Shenzhen,3,273,270
2024-04-10,PROD019,Shanghai,8,916,908
2024-04-11,PROD011,Jilin,7,344,337
2024-04-12,PROD006,Guangzhou,2,1092,1090
2024-04-13,PROD014,Beijing,7,410,403
2024-04-14,PROD012,Shenzhen,6,201,195
2024-04-15,PROD012,Beijing,2,925,923
2024-04-16,PROD017,Shanghai,1,644,643
2024-04-17,PROD006,Shanghai,5,236,231
2024-04-18,PROD014,Shanghai,4,503,499
2024-04-19,PROD010,Shenzhen,6,751,745
2024-04-20,PROD017,Shanghai,9,643,634
2024-04-21,PROD011,Guangzhou,4,629,625
2024-04-22,PROD019,Shenzhen,2,542,540
2024-04-23,PROD014,Guangzhou,6,265,259
2024-04-24,PROD001,Guangzhou,9,1038,1029
2024-04-25,PROD002,Jilin,6,721,715
2024-04-26,PROD019,Beijing,1,531,530
2024-04-27,PROD007,Jilin,4,250,246
2024-04-28,PROD018,Jilin,8,1236,1228
2024-04-29,PROD010,Shanghai,8,486,478
2024-04-30,PROD020,Beijing,10,888,878
2024-05-01,PROD019,Shenzhen,8,540,532
2024-05-02,PROD019,Shanghai,6,908,902
2024-05-03,PROD007,Jilin,5,246,241
2024-05-04,PROD016,Shenzhen,6,250,244
2024-05-05,PROD006,Jilin,4,676,672
2024-05-06,PROD010,Guangzhou,8,1155,1147
2024-05-07,PROD010,Shanghai,2,478,476
2024-05-08,PROD003,Beijing,2,1125,1123
2024-05-09,PROD007,Guangzhou,6,862,856
2024-05-10,PROD013,Jilin,6,726,720
2024-05-11,PROD005,Guangzhou,8,366,358
2024-05-12,PROD008,Shanghai,7,313,306
2024-05-13,PROD019,Shanghai,1,902,901
2024-05-14,PROD013,Shenzhen,8,1028,1020
2024-05-15,PROD010,Beijing,7,1131,1124
2024-05-16,PROD019,Shanghai,9,901,892
2024-05-17,PROD015,Shanghai,6,283,277
2024-05-18,PROD001,Shenzhen,9,491,482
2024-05-19,PROD013,Shanghai,1,847,846
2024-05-20,PROD019,Shanghai,1,892,891
2024-05-21,PROD015,Guangzhou,1,598,597
2024-05-22,PROD002,Guangzhou,9,844,835
2024-05-23,PROD006,Shenzhen,4,270,266
2024-05-24,PROD019,Guangzhou,1,1043,1042
2024-05-25,PROD015,Jilin,9,910,901
2024-05-26,PROD011,Jilin,4,337,333
2024-05-27,PROD010,Shanghai,4,476,472
2024-05-28,PROD020,Shenzhen,10,979,969
2024-05-29,PROD019,Beijing,1,530,529
2024-05-30,PROD010,Jilin,6,294,288
2024-05-31,PROD002,Guangzhou,1,835,834
2024-06-01,PROD002,Shanghai,7,404,397
2024-06-02,PROD018,Guangzhou,2,884,882
2024-06-03,PROD020,Jilin,1,1031,1030
2024-06-04,PROD005,Beijing,2,541,539
2024-06-05,PROD005,Guangzhou,6,358,352
2024-06-06,PROD012,Jilin,8,760,752
2024-06-07,PROD012,Beijing,5,923,918
2024-06-08,PROD012,Guangzhou,8,310,302
2024-06-09,PROD020,Beijing,6,878,872
2024-06-10,PROD019,Guangzhou,1,1042,1041
2024-06-11,PROD008,Shanghai,8,306,298
2024-06-12,PROD009,Guangzhou,4,1078,1074
2024-06-13,PROD016,Shanghai,8,1032,1024
2024-06-14,PROD007,Guangzhou,5,856,851
2024-06-15,PROD010,Beijing,10,1124,1114
2024-06-16,PROD006,Jilin,7,672,665
2024-06-17,PROD001,Shanghai,2,847,845
2024-06-18,PROD002,Beijing,2,796,794
2024-06-19,PROD002,Beijing,5,794,789
2024-06-20,PROD018,Jilin,1,1228,1227
2024-06-21,PROD018,Guangzhou,8,882,874
2024-06-22,PROD003,Guangzhou,8,887,879
2024-06-23,PROD015,Guangzhou,10,597,587
2024-06-24,PROD015,Beijing,6,712,706
2024-06-25,PROD002,Jilin,6,715,709
2024-06-26,PROD012,Shanghai,5,746,741
2024-06-27,PROD016,Beijing,10,1012,1002
2024-06-28,PROD005,Jilin,5,651,646
2024-06-29,PROD005,Guangzhou,1,352,351
2024-06-30,PROD016,Jilin,2,579,577
2024-07-01,PROD019,Jilin,4,765,761
2024-07-02,PROD016,Guangzhou,3,281,278
2024-07-03,PROD006,Shanghai,1,231,230
2024-07-04,PROD012,Beijing,9,918,909
2024-07-05,PROD017,Shanghai,8,634,626
2024-07-06,PROD018,Shanghai,9,740,731
2024-07-07,PROD007,Jilin,7,241,234
2024-07-08,PROD014,Beijing,1,403,402
2024-07-09,PROD003,Jilin,9,1071,1062
2024-07-10,PROD002,Shenzhen,7,998,991
2024-07-11,PROD019,Jilin,4,761,757
2024-07-12,PROD006,Shenzhen,5,266,261
2024-07-13,PROD015,Shenzhen,10,646,636
2024-07-14,PROD013,Guangzhou,3,549,546
2024-07-15,PROD012,Beijing,3,909,906
2024-07-16,PROD009,Shanghai,7,480,473
2024-07-17,PROD017,Jilin,2,987,985
2024-07-18,PROD004,Shanghai,9,1112,1103
2024-07-19,PROD005,Guangzhou,2,351,349
2024-07-20,PROD008,Shenzhen,3,596,593
2024-07-21,PROD008,Jilin,10,499,489
2024-07-22,PROD013,Jilin,10,720,710
2024-07-23,PROD015,Beijing,9,706,697
2024-07-24,PROD014,Jilin,1,555,554
2024-07-25,PROD016,Beijing,9,1002,993
2024-07-26,PROD010,Guangzhou,10,1147,1137
2024-07-27,PROD016,Shenzhen,8,244,236
2024-07-28,PROD010,Shanghai,9,472,463
2024-07-29,PROD011,Jilin,10,333,323
2024-07-30,PROD015,Beijing,1,697,696
2024-07-31,PROD017,Beijing,1,1089,1088
2024-08-01,PROD020,Jilin,8,1030,1022
2024-08-02,PROD018,Shenzhen,2,1002,1000
2024-08-03,PROD010,Jilin,6,288,282
2024-08-04,PROD019,Guangzhou,5,1041,1036
2024-08-05,PROD016,Shanghai,10,1024,1014
2024-08-06,PROD019,Jilin,10,757,747
2024-08-07,PROD011,Shanghai,8,444,436
2024-08-08,PROD015,Jilin,5,901,896
2024-08-09,PROD007,Beijing,3,140,137
2024-08-10,PROD016,Beijing,2,993,991
2024-08-11,PROD003,Shanghai,6,968,962
2024-08-12,PROD016,Shanghai,3,1014,1011
2024-08-13,PROD017,Guangzhou,3,274,271
2024-08-14,PROD018,Shenzhen,1,1000,999
2024-08-15,PROD003,Beijing,3,1123,1120
2024-08-16,PROD004,Guangzhou,2,1128,1126
2024-08-17,PROD004,Guangzhou,10,1126,1116
2024-08-18,PROD014,Beijing,1,402,401
2024-08-19,PROD015,Guangzhou,1,587,586
2024-08-20,PROD011,Beijing,9,1267,1258
2024-08-21,PROD006,Jilin,7,665,658
2024-08-22,PROD004,Shanghai,3,1103,1100
2024-08-23,PROD020,Beijing,6,872,866
2024-08-24,PROD010,Guangzhou,7,1137,1130
2024-08-25,PROD014,Shanghai,9,499,490
2024-08-26,PROD020,Shanghai,10,298,288
2024-08-27,PROD004,Shenzhen,6,366,360
2024-08-28,PROD013,Shanghai,7,846,839
2024-08-29,PROD004,Guangzhou,3,1116,1113
2024-08-30,PROD005,Guangzhou,1,349,348
2024-08-31,PROD020,Shenzhen,2,969,967
2024-09-01,PROD013,Jilin,9,710,701
2024-09-02,PROD011,Beijing,4,1258,1254
2024-09-03,PROD006,Jilin,1,658,657
2024-09-04,PROD010,Guangzhou,2,1130,1128
2024-09-05,PROD011,Jilin,6,323,317
2024-09-06,PROD008,Jilin,2,489,487
2024-09-07,PROD005,Shanghai,2,712,710
2024-09-08,PROD018,Jilin,1,1227,1226
2024-09-09,PROD017,Jilin,8,985,977
2024-09-10,PROD003,Jilin,6,1062,1056
2024-09-11,PROD014,Beijing,1,401,400
2024-09-12,PROD015,Shenzhen,9,636,627
2024-09-13,PROD002,Shenzhen,1,991,990
2024-09-14,PROD015,Shanghai,3,277,274
2024-09-15,PROD019,Shenzhen,1,532,531
2024-09-16,PROD003,Shanghai,7,962,955
2024-09-17,PROD002,Jilin,4,709,705
2024-09-18,PROD017,Guangzhou,5,271,266
2024-09-19,PROD007,Jilin,1,234,233
2024-09-20,PROD011,Guangzhou,9,625,616
2024-09-21,PROD016,Shenzhen,1,236,235
2024-09-22,PROD004,Guangzhou,4,1113,1109
2024-09-23,PROD004,Shenzhen,9,360,351
2024-09-24,PROD008,Guangzhou,6,1142,1136
2024-09-25,PROD011,Jilin,1,317,316
2024-09-26,PROD002,Guangzhou,5,834,829
2024-09-27,PROD005,Shanghai,10,710,700
2024-09-28,PROD020,Guangzhou,10,386,376
2024-09-29,PROD004,Guangzhou,2,1109,1107
2024-09-30,PROD003,Shanghai,7,955,948
2024-10-01,PROD008,Beijing,3,382,379
2024-10-02,PROD007,Jilin,5,233,228
2024-10-03,PROD005,Beijing,8,539,531
2024-10-04,PROD009,Shenzhen,7,515,508
2024-10-05,PROD018,Shenzhen,9,999,990
2024-10-06,PROD020,Jilin,10,1022,1012
2024-10-07,PROD002,Shenzhen,5,990,985
2024-10-08,PROD017,Shanghai,4,626,622
2024-10-09,PROD009,Shanghai,2,473,471
2024-10-10,PROD017,Shenzhen,4,684,680
2024-10-11,PROD008,Guangzhou,3,1136,1133
2024-10-12,PROD012,Jilin,8,752,744
2024-10-13,PROD013,Shanghai,5,839,834
2024-10-14,PROD008,Shanghai,5,298,293
2024-10-15,PROD012,Shenzhen,7,195,188
2024-10-16,PROD002,Beijing,8,789,781
2024-10-17,PROD009,Beijing,8,385,377
2024-10-18,PROD020,Shenzhen,9,967,958
2024-10-19,PROD004,Beijing,7,540,533
2024-10-20,PROD016,Shanghai,3,1011,1008
2024-10-21,PROD019,Jilin,7,747,740
2024-10-22,PROD017,Jilin,9,977,968
2024-10-23,PROD016,Guangzhou,6,278,272
2024-10-24,PROD019,Shenzhen,5,531,526
2024-10-25,PROD012,Shenzhen,10,188,178
2024-10-26,PROD004,Jilin,6,208,202
2024-10-27,PROD012,Jilin,3,744,741
2024-10-28,PROD012,Jilin,4,741,737
2024-10-29,PROD017,Jilin,7,968,961
2024-10-30,PROD002,Shenzhen,1,985,984
2024-10-31,PROD017,Jilin,1,961,960
2024-11-01,PROD004,Guangzhou,5,1107,1102
2024-11-02,PROD020,Guangzhou,3,376,373
2024-11-03,PROD005,Jilin,1,646,645
2024-11-04,PROD002,Guangzhou,10,829,819
2024-11-05,PROD017,Shenzhen,8,680,672
2024-11-06,PROD010,Shenzhen,2,745,743
2024-11-07,PROD013,Guangzhou,7,546,539
2024-11-08,PROD010,Shanghai,3,463,460
2024-11-09,PROD015,Jilin,8,896,888
2024-11-10,PROD008,Guangzhou,3,1133,1130
2024-11-11,PROD018,Beijing,6,751,745
2024-11-12,PROD005,Shanghai,4,700,696
2024-11-13,PROD001,Shanghai,7,845,838
2024-11-14,PROD007,Guangzhou,4,851,847
2024-11-15,PROD009,Shenzhen,4,508,504
2024-11-16,PROD001,Shenzhen,7,482,475
2024-11-17,PROD003,Guangzhou,4,879,875
2024-11-18,PROD008,Shanghai,2,293,291
2024-11-19,PROD013,Jilin,10,701,691
2024-11-20,PROD014,Jilin,10,554,544
2024-11-21,PROD004,Shenzhen,4,351,347
2024-11-22,PROD004,Shenzhen,6,347,341
2024-11-23,PROD008,Shenzhen,8,593,585
2024-11-24,PROD014,Shenzhen,4,536,532
2024-11-25,PROD009,Beijing,7,377,370
2024-11-26,PROD020,Shanghai,10,288,278
2024-11-27,PROD011,Beijing,9,1254,1245
2024-11-28,PROD002,Shenzhen,8,984,976
2024-11-29,PROD004,Shenzhen,2,341,339
2024-11-30,PROD018,Jilin,2,1226,1224
2024-12-01,PROD006,Shenzhen,10,261,251
2024-12-02,PROD001,Shenzhen,5,475,470
2024-12-03,PROD011,Jilin,10,316,306
2024-12-04,PROD004,Jilin,7,202,195
2024-12-05,PROD012,Shanghai,8,741,733
2024-12-06,PROD011,Beijing,7,1245,1238
2024-12-07,PROD011,Shanghai,9,436,427
2024-12-08,PROD008,Guangzhou,7,1130,1123
2024-12-09,PROD019,Guangzhou,1,1036,1035
2024-12-10,PROD001,Jilin,1,391,390
2024-12-11,PROD019,Jilin,6,740,734
2024-12-12,PROD010,Shanghai,9,460,451
2024-12-13,PROD006,Beijing,1,796,795
2024-12-14,PROD014,Shanghai,7,490,483
2024-12-15,PROD020,Beijing,3,866,863
2024-12-16,PROD009,Shanghai,9,471,462
2024-12-17,PROD015,Jilin,9,888,879
2024-12-18,PROD003,Jilin,1,1056,1055
2024-12-19,PROD011,Guangzhou,7,616,609
2024-12-20,PROD002,Beijing,4,781,777
2024-12-21,PROD011,Jilin,3,306,303
2024-12-22,PROD017,Beijing,7,1088,1081
2024-12-23,PROD007,Beijing,4,137,133
2024-12-24,PROD006,Guangzhou,5,1090,1085
2024-12-25,PROD011,Jilin,1,303,302
2024-12-26,PROD006,Shenzhen,6,251,245
2024-12-27,PROD015,Jilin,8,879,871
2024-12-28,PROD014,Beijing,2,400,398
2024-12-29,PROD020,Shanghai,3,278,275
2024-12-30,PROD004,Guangzhou,6,1102,1096
2024-01-01,PROD002,Guangzhou,9,819,810
2024-01-02,PROD016,Guangzhou,3,272,269
2024-01-03,PROD016,Jilin,10,577,567
2024-01-04,PROD011,Jilin,9,302,293
2024-01-05,PROD010,Shenzhen,6,743,737
2024-01-06,PROD001,Shanghai,8,838,830
2024-01-07,PROD015,Beijing,7,696,689
2024-01-08,PROD002,Jilin,9,705,696
2024-01-09,PROD007,Shanghai,9,479,470
2024-01-10,PROD014,Guangzhou,6,259,253
2024-01-11,PROD017,Guangzhou,7,266,259
2024-01-12,PROD006,Guangzhou,5,1085,1080
2024-01-13,PROD009,Guangzhou,10,1074,1064
2024-01-14,PROD008,Guangzhou,4,1123,1119
2024-01-15,PROD002,Jilin,6,696,690
2024-01-16,PROD001,Shenzhen,3,470,467
2024-01-17,PROD019,Shanghai,1,891,890
2024-01-18,PROD007,Guangzhou,5,847,842
2024-01-19,PROD008,Shanghai,2,291,289
2024-01-20,PROD008,Shenzhen,1,585,584
2024-01-21,PROD013,Shanghai,9,834,825
2024-01-22,PROD004,Shenzhen,5,339,334
2024-01-23,PROD019,Beijing,7,529,522
2024-01-24,PROD002,Shenzhen,1,976,975
2024-01-25,PROD005,Jilin,7,645,638
2024-01-26,PROD020,Jilin,4,1012,1008
2024-01-27,PROD001,Beijing,3,206,203
2024-01-28,PROD020,Shenzhen,7,958,951
2024-01-29,PROD006,Shanghai,7,230,223
2024-01-30,PROD013,Shenzhen,7,1020,1013
2024-01-31,PROD006,Guangzhou,10,1080,1070
2024-02-01,PROD003,Guangzhou,3,875,872
2024-02-02,PROD005,Shanghai,7,696,689
2024-02-03,PROD008,Jilin,8,487,479
2024-02-04,PROD007,Shenzhen,4,418,414
2024-02-05,PROD015,Guangzhou,3,586,583
2024-02-06,PROD014,Shenzhen,2,532,530
2024-02-07,PROD016,Guangzhou,10,269,259
2024-02-08,PROD006,Shanghai,2,223,221
2024-02-09,PROD018,Jilin,1,1224,1223
2024-02-10,PROD017,Guangzhou,10,259,249
2024-02-11,PROD004,Shanghai,9,1100,1091
2024-02-12,PROD015,Guangzhou,5,583,578
2024-02-13,PROD007,Beijing,1,133,132
2024-02-14,PROD013,Shanghai,10,825,815
2024-02-15,PROD014,Beijing,6,398,392
2024-02-16,PROD002,Shenzhen,2,975,973
2024-02-17,PROD020,Jilin,6,1008,1002
2024-02-18,PROD010,Shenzhen,3,737,734
2024-02-19,PROD019,Guangzhou,1,1035,1034
2024-02-20,PROD002,Jilin,1,690,689
2024-02-21,PROD002,Shenzhen,1,973,972
2024-02-22,PROD017,Shenzhen,7,672,665
2024-02-23,PROD016,Beijing,7,991,984
2024-02-24,PROD016,Guangzhou,3,259,256
2024-02-25,PROD006,Jilin,8,657,649
2024-02-26,PROD005,Beijing,5,531,526
2024-02-27,PROD008,Jilin,10,479,469
2024-02-28,PROD013,Jilin,5,691,686
2024-02-29,PROD019,Shanghai,5,890,885
2024-03-01,PROD008,Shenzhen,10,584,574
2024-03-02,PROD011,Jilin,8,293,285
2024-03-03,PROD019,Guangzhou,9,1034,1025
2024-03-04,PROD002,Jilin,1,689,688
2024-03-05,PROD002,Beijing,2,777,775
2024-03-06,PROD013,Shenzhen,4,1013,1009
2024-03-07,PROD008,Shenzhen,2,574,572
2024-03-08,PROD020,Guangzhou,4,373,369
2024-03-09,PROD018,Shenzhen,4,990,986
2024-03-10,PROD013,Shenzhen,7,1009,1002
2024-03-11,PROD007,Jilin,1,228,227
2024-03-12,PROD001,Shanghai,3,830,827
2024-03-13,PROD018,Shenzhen,6,986,980
2024-03-14,PROD017,Guangzhou,2,249,247
2024-03-15,PROD007,Jilin,7,227,220
2024-03-16,PROD001,Beijing,7,203,196
2024-03-17,PROD009,Shanghai,3,462,459
2024-03-18,PROD006,Shenzhen,10,245,235
2024-03-19,PROD003,Beijing,1,1120,1119
2024-03-20,PROD019,Shenzhen,8,526,518
2024-03-21,PROD015,Beijing,8,689,681
2024-03-22,PROD001,Shenzhen,9,467,458
2024-03-23,PROD008,Shanghai,6,289,283
2024-03-24,PROD019,Guangzhou,10,1025,1015
2024-03-25,PROD020,Shanghai,3,275,272
2024-03-26,PROD019,Jilin,2,734,732
2024-03-27,PROD016,Shanghai,5,1008,1003
2024-03-28,PROD007,Jilin,9,220,211
2024-03-29,PROD010,Shenzhen,7,734,727
2024-03-30,PROD001,Shenzhen,3,458,455
2024-03-31,PROD002,Guangzhou,7,810,803
2024-04-01,PROD014,Shanghai,6,483,477
2024-04-02,PROD010,Shenzhen,6,727,721
2024-04-03,PROD011,Shanghai,8,427,419
2024-04-04,PROD011,Jilin,10,285,275
2024-04-05,PROD002,Jilin,6,688,682
2024-04-06,PROD008,Shenzhen,7,572,565
2024-04-07,PROD016,Beijing,4,984,980
2024-04-08,PROD008,Beijing,2,379,377
2024-04-09,PROD014,Shanghai,9,477,468
2024-04-10,PROD015,Guangzhou,3,578,575
2024-04-11,PROD012,Jilin,2,737,735
2024-04-12,PROD020,Beijing,1,863,862
2024-04-13,PROD001,Beijing,7,196,189
2024-04-14,PROD007,Beijing,2,132,130
2024-04-15,PROD018,Jilin,8,1223,1215
2024-04-16,PROD003,Jilin,1,1055,1054
2024-04-17,PROD003,Guangzhou,7,872,865
2024-04-18,PROD009,Jilin,1,275,274
2024-04-19,PROD011,Beijing,5,1238,1233
2024-04-20,PROD011,Shanghai,8,419,411
2024-04-21,PROD017,Guangzhou,1,247,246
2024-04-22,PROD004,Shenzhen,1,334,333
2024-04-23,PROD010,Guangzhou,4,1128,1124
2024-04-24,PROD018,Jilin,3,1215,1212
2024-04-25,PROD008,Beijing,7,377,370
2024-04-26,PROD019,Beijing,10,522,512
2024-04-27,PROD007,Guangzhou,1,842,841
2024-04-28,PROD002,Guangzhou,3,803,800
2024-04-29,PROD006,Guangzhou,3,1070,1067
2024-04-30,PROD004,Guangzhou,3,1096,1093
2024-05-01,PROD013,Beijing,2,1001,999
2024-05-02,PROD003,Shanghai,2,948,946
2024-05-03,PROD005,Beijing,5,526,521
2024-05-04,PROD007,Guangzhou,2,841,839
2024-05-05,PROD006,Guangzhou,7,1067,1060
2024-05-06,PROD011,Beijing,2,1233,1231
2024-05-07,PROD001,Jilin,1,390,389
2024-05-08,PROD011,Beijing,7,1231,1224
2024-05-09,PROD019,Shanghai,10,885,875
2024-05-10,PROD004,Shanghai,4,1091,1087
2024-05-11,PROD009,Shanghai,7,459,452
2024-05-12,PROD006,Jilin,5,649,644
2024-05-13,PROD009,Shanghai,4,452,448
2024-05-14,PROD017,Beijing,3,1081,1078
2024-05-15,PROD020,Shenzhen,8,951,943
2024-05-16,PROD017,Beijing,7,1078,1071
2024-05-17,PROD017,Beijing,3,1071,1068
2024-05-18,PROD012,Beijing,8,906,898
2024-05-19,PROD013,Jilin,4,686,682
2024-05-20,PROD007,Guangzhou,7,839,832
2024-05-21,PROD008,Shanghai,6,283,277
2024-05-22,PROD002,Jilin,7,682,675
2024-05-23,PROD002,Guangzhou,5,800,795
2024-05-24,PROD019,Shanghai,8,875,867
2024-05-25,PROD013,Jilin,10,682,672
2024-05-26,PROD010,Jilin,9,282,273
2024-05-27,PROD002,Shanghai,2,397,395
2024-05-28,PROD005,Guangzhou,7,348,341
2024-05-29,PROD006,Jilin,6,644,638
2024-05-30,PROD010,Shenzhen,10,721,711
2024-05-31,PROD002,Jilin,5,675,670
2024-06-01,PROD001,Shenzhen,10,455,445
2024-06-02,PROD001,Shanghai,2,827,825
2024-06-03,PROD002,Jilin,4,670,666
2024-06-04,PROD006,Shenzhen,6,235,229
2024-06-05,PROD008,Shanghai,5,277,272
2024-06-06,PROD020,Jilin,10,1002,992
2024-06-07,PROD001,Shanghai,3,825,822
2024-06-08,PROD014,Shenzhen,8,530,522
2024-06-09,PROD011,Shanghai,2,411,409
2024-06-10,PROD014,Guangzhou,2,253,251
2024-06-11,PROD008,Guangzhou,4,1119,1115
2024-06-12,PROD013,Shanghai,10,815,805
2024-06-13,PROD018,Guangzhou,5,874,869
2024-06-14,PROD020,Jilin,3,992,989
2024-06-15,PROD014,Shenzhen,2,522,520
2024-06-16,PROD002,Shenzhen,4,972,968
2024-06-17,PROD001,Shanghai,1,822,821
2024-06-18,PROD014,Shenzhen,2,520,518
2024-06-19,PROD018,Shanghai,2,731,729
2024-06-20,PROD005,Shanghai,1,689,688
2024-06-21,PROD004,Guangzhou,6,1093,1087
2024-06-22,PROD013,Beijing,5,999,994
2024-06-23,PROD010,Shenzhen,10,711,701
2024-06-24,PROD015,Shanghai,10,274,264
2024-06-25,PROD010,Guangzhou,9,1124,1115
2024-06-26,PROD018,Jilin,2,1212,1210
2024-06-27,PROD004,Guangzhou,6,1087,1081
2024-06-28,PROD018,Jilin,2,1210,1208
2024-06-29,PROD010,Jilin,1,273,272
2024-06-30,PROD012,Beijing,9,898,889
2024-07-01,PROD019,Jilin,10,732,722
2024-07-02,PROD005,Guangzhou,2,341,339
2024-07-03,PROD014,Shanghai,9,468,459
2024-07-04,PROD010,Guangzhou,5,1115,1110
2024-07-05,PROD006,Guangzhou,5,1060,1055
2024-07-06,PROD004,Guangzhou,5,1081,1076
2024-07-07,PROD014,Shenzhen,10,518,508
2024-07-08,PROD008,Beijing,9,370,361
2024-07-09,PROD009,Beijing,2,370,368
2024-07-10,PROD014,Shanghai,4,459,455
2024-07-11,PROD003,Shenzhen,3,893,890
2024-07-12,PROD012,Jilin,6,735,729
2024-07-13,PROD007,Beijing,3,130,127
2024-07-14,PROD017,Beijing,6,1068,1062
2024-07-15,PROD012,Guangzhou,4,302,298
2024-07-16,PROD007,Beijing,10,127,117
2024-07-17,PROD004,Shanghai,10,1087,1077
2024-07-18,PROD008,Guangzhou,9,1115,1106
2024-07-19,PROD017,Shenzhen,10,665,655
2024-07-20,PROD010,Shenzhen,3,701,698
2024-07-21,PROD015,Guangzhou,4,575,571
2024-07-22,PROD013,Shanghai,10,805,795
2024-07-23,PROD015,Guangzhou,1,571,570
2024-07-24,PROD019,Jilin,4,722,718
2024-07-25,PROD009,Shenzhen,6,504,498
2024-07-26,PROD014,Jilin,3,544,541
2024-07-27,PROD020,Guangzhou,10,369,359
2024-07-28,PROD006,Beijing,1,795,794
2024-07-29,PROD002,Shenzhen,10,968,958
2024-07-30,PROD009,Jilin,10,274,264
2024-07-31,PROD008,Shenzhen,1,565,564
2024-08-01,PROD005,Beijing,4,521,517
2024-08-02,PROD016,Guangzhou,4,256,252
2024-08-03,PROD003,Guangzhou,2,865,863
2024-08-04,PROD018,Jilin,1,1208,1207
2024-08-05,PROD006,Guangzhou,1,1055,1054
2024-08-06,PROD011,Shenzhen,1,799,798
2024-08-07,PROD014,Beijing,2,392,390
2024-08-08,PROD006,Guangzhou,7,1054,1047
2024-08-09,PROD014,Beijing,9,390,381
2024-08-10,PROD004,Beijing,6,533,527
2024-08-11,PROD002,Shanghai,5,395,390
2024-08-12,PROD003,Beijing,3,1119,1116
2024-08-13,PROD014,Jilin,6,541,535
2024-08-14,PROD019,Shanghai,9,867,858
2024-08-15,PROD001,Jilin,7,389,382
2024-08-16,PROD003,Shanghai,4,946,942
2024-08-17,PROD012,Shenzhen,8,178,170
2024-08-18,PROD013,Beijing,5,994,989
2024-08-19,PROD016,Shenzhen,10,235,225
2024-08-20,PROD007,Shenzhen,7,414,407
2024-08-21,PROD014,Shanghai,8,455,447
2024-08-22,PROD018,Shenzhen,6,980,974
2024-08-23,PROD001,Jilin,10,382,372
2024-08-24,PROD001,Guangzhou,3,1029,1026
2024-08-25,PROD005,Beijing,2,517,515
2024-08-26,PROD014,Jilin,3,535,532
2024-08-27,PROD017,Shenzhen,2,655,653
2024-08-28,PROD008,Beijing,8,361,353
2024-08-29,PROD010,Shenzhen,3,698,695
2024-08-30,PROD006,Shanghai,10,221,211
2024-08-31,PROD008,Jilin,9,469,460
2024-09-01,PROD009,Jilin,4,264,260
2024-09-02,PROD003,Jilin,1,1054,1053
2024-09-03,PROD011,Jilin,5,275,270
2024-09-04,PROD017,Beijing,1,1062,1061
2024-09-05,PROD003,Shenzhen,10,890,880
2024-09-06,PROD010,Guangzhou,10,1110,1100
2024-09-07,PROD014,Shenzhen,10,508,498
2024-09-08,PROD016,Guangzhou,6,252,246
2024-09-09,PROD013,Guangzhou,3,539,536
2024-09-10,PROD010,Jilin,10,272,262
2024-09-11,PROD017,Shanghai,7,622,615
2024-09-12,PROD008,Shenzhen,2,564,562
2024-09-13,PROD010,Guangzhou,4,1100,1096
2024-09-14,PROD015,Jilin,7,871,864
2024-09-15,PROD004,Shanghai,9,1077,1068
2024-09-16,PROD007,Shanghai,6,470,464
2024-09-17,PROD020,Guangzhou,4,359,355
2024-09-18,PROD002,Shanghai,7,390,383
2024-09-19,PROD020,Shanghai,8,272,264
2024-09-20,PROD005,Beijing,5,515,510
2024-09-21,PROD001,Beijing,1,189,188
2024-09-22,PROD019,Shenzhen,1,518,517
2024-09-23,PROD012,Shenzhen,5,170,165
2024-09-24,PROD013,Shanghai,2,795,793
2024-09-25,PROD014,Guangzhou,6,251,245
2024-09-26,PROD014,Shanghai,3,447,444
2024-09-27,PROD002,Guangzhou,5,795,790
2024-09-28,PROD012,Beijing,4,889,885
2024-09-29,PROD010,Beijing,2,1114,1112
2024-09-30,PROD013,Beijing,8,989,981
2024-10-01,PROD012,Shanghai,8,733,725
2024-10-02,PROD010,Shanghai,6,451,445
2024-10-03,PROD017,Beijing,7,1061,1054
2024-10-04,PROD008,Beijing,3,353,350
2024-10-05,PROD014,Guangzhou,5,245,240
2024-10-06,PROD013,Shenzhen,4,1002,998
2024-10-07,PROD009,Beijing,6,368,362
2024-10-08,PROD004,Beijing,4,527,523
2024-10-09,PROD016,Jilin,2,567,565
2024-10-10,PROD005,Guangzhou,6,339,333
2024-10-11,PROD015,Jilin,2,864,862
2024-10-12,PROD020,Shanghai,8,264,256
2024-10-13,PROD006,Beijing,9,794,785
2024-10-14,PROD003,Guangzhou,9,863,854
2024-10-15,PROD015,Guangzhou,7,570,563
2024-10-16,PROD013,Shenzhen,8,998,990
2024-10-17,PROD006,Jilin,6,638,632
2024-10-18,PROD015,Guangzhou,4,563,559
2024-10-19,PROD003,Guangzhou,8,854,846
2024-10-20,PROD016,Beijing,3,980,977
2024-10-21,PROD016,Shanghai,6,1003,997
2024-10-22,PROD002,Shanghai,8,383,375
2024-10-23,PROD011,Shenzhen,2,798,796
2024-10-24,PROD017,Beijing,4,1054,1050
2024-10-25,PROD012,Shenzhen,2,165,163
2024-10-26,PROD008,Jilin,6,460,454
2024-10-27,PROD012,Shanghai,7,725,718
2024-10-28,PROD012,Beijing,10,885,875
2024-10-29,PROD016,Beijing,8,977,969
2024-10-30,PROD003,Shenzhen,4,880,876
2024-10-31,PROD015,Beijing,8,681,673
2024-11-01,PROD003,Beijing,8,1116,1108
2024-11-02,PROD019,Guangzhou,9,1015,1006
2024-11-03,PROD004,Shenzhen,10,333,323
2024-11-04,PROD004,Shanghai,9,1068,1059
2024-11-05,PROD018,Shenzhen,3,974,971
2024-11-06,PROD014,Jilin,3,532,529
2024-11-07,PROD002,Beijing,5,775,770
2024-11-08,PROD010,Jilin,10,262,252
2024-11-09,PROD009,Guangzhou,1,1064,1063
2024-11-10,PROD015,Jilin,8,862,854
2024-11-11,PROD009,Beijing,6,362,356
2024-11-12,PROD002,Jilin,8,666,658
2024-11-13,PROD003,Shanghai,1,942,941
2024-11-14,PROD011,Guangzhou,2,609,607
2024-11-15,PROD019,Shanghai,3,858,855
2024-11-16,PROD005,Beijing,5,510,505
2024-11-17,PROD010,Shanghai,7,445,438
2024-11-18,PROD015,Shenzhen,9,627,618
2024-11-19,PROD011,Beijing,2,1224,1222
2024-11-20,PROD004,Guangzhou,8,1076,1068
2024-11-21,PROD013,Shenzhen,5,990,985
2024-11-22,PROD018,Beijing,8,745,737
2024-11-23,PROD020,Shanghai,5,256,251
2024-11-24,PROD009,Jilin,7,260,253
2024-11-25,PROD012,Beijing,8,875,867
2024-11-26,PROD012,Shenzhen,9,163,154
2024-11-27,PROD020,Jilin,3,989,986
2024-11-28,PROD014,Shenzhen,6,498,492
2024-11-29,PROD006,Shenzhen,3,229,226
2024-11-30,PROD011,Guangzhou,4,607,603
2024-12-01,PROD007,Jilin,8,211,203
2024-12-02,PROD003,Jilin,6,1053,1047
2024-12-03,PROD013,Guangzhou,7,536,529
2024-12-04,PROD016,Shanghai,2,997,995
2024-12-05,PROD019,Shanghai,7,855,848
2024-12-06,PROD007,Shenzhen,3,407,404
2024-12-07,PROD009,Jilin,5,253,248
2024-12-08,PROD020,Shenzhen,10,943,933
2024-12-09,PROD006,Guangzhou,5,1047,1042
2024-12-10,PROD013,Beijing,5,981,976
2024-12-11,PROD013,Shanghai,3,793,790
2024-12-12,PROD011,Beijing,9,1222,1213
2024-12-13,PROD014,Shenzhen,6,492,486
2024-12-14,PROD011,Shanghai,1,409,408
2024-12-15,PROD013,Beijing,3,976,973
2024-12-16,PROD020,Guangzhou,10,355,345
2024-12-17,PROD020,Jilin,8,986,978
2024-12-18,PROD007,Jilin,6,203,197
2024-12-19,PROD002,Shenzhen,3,958,955
2024-12-20,PROD018,Guangzhou,8,869,861
2024-12-21,PROD020,Guangzhou,1,345,344
2024-12-22,PROD018,Beijing,3,737,734
2024-12-23,PROD013,Guangzhou,3,529,526
2024-12-24,PROD012,Guangzhou,2,298,296
2024-12-25,PROD013,Shanghai,6,790,784
2024-12-26,PROD011,Shanghai,6,408,402
2024-12-27,PROD015,Shanghai,3,264,261
2024-12-28,PROD003,Shanghai,3,941,938
2024-12-29,PROD014,Beijing,8,381,373
2024-12-30,PROD015,Guangzhou,2,559,557
2024-01-01,PROD002,Jilin,4,658,654
2024-01-02,PROD002,Shenzhen,4,955,951
2024-01-03,PROD008,Beijing,6,350,344
2024-01-04,PROD003,Guangzhou,10,846,836
2024-01-05,PROD007,Guangzhou,2,832,830
2024-01-06,PROD005,Guangzhou,7,333,326
2024-01-07,PROD015,Beijing,6,673,667
2024-01-08,PROD018,Shanghai,2,729,727
2024-01-09,PROD010,Beijing,8,1112,1104
2024-01-10,PROD010,Guangzhou,5,1096,1091
2024-01-11,PROD010,Guangzhou,3,1091,1088
2024-01-12,PROD006,Guangzhou,2,1042,1040
2024-01-13,PROD017,Jilin,1,960,959
2024-01-14,PROD018,Shanghai,8,727,719
2024-01-15,PROD001,Shanghai,9,821,812
2024-01-16,PROD015,Shenzhen,4,618,614
2024-01-17,PROD012,Shanghai,9,718,709
2024-01-18,PROD008,Jilin,6,454,448
2024-01-19,PROD016,Guangzhou,3,246,243
2024-01-20,PROD015,Shanghai,5,261,256
2024-01-21,PROD016,Jilin,3,565,562
2024-01-22,PROD001,Beijing,6,188,182
2024-01-23,PROD016,Guangzhou,10,243,233
2024-01-24,PROD014,Beijing,2,373,371
2024-01-25,PROD006,Guangzhou,5,1040,1035
2024-01-26,PROD007,Shanghai,4,464,460
2024-01-27,PROD012,Jilin,7,729,722
2024-01-28,PROD020,Beijing,7,862,855
2024-01-29,PROD015,Shenzhen,1,614,613
2024-01-30,PROD011,Jilin,9,270,261
2024-01-31,PROD012,Beijing,7,867,860
2024-02-01,PROD002,Beijing,2,770,768
2024-02-02,PROD015,Guangzhou,4,557,553
2024-02-03,PROD019,Jilin,6,718,712
2024-02-04,PROD017,Jilin,10,959,949
2024-02-05,PROD011,Shenzhen,3,796,793
2024-02-06,PROD001,Beijing,5,182,177
2024-02-07,PROD012,Shenzhen,1,154,153
2024-02-08,PROD008,Shanghai,2,272,270
2024-02-09,PROD019,Jilin,7,712,705
2024-02-10,PROD007,Shenzhen,7,404,397
2024-02-11,PROD017,Shenzhen,4,653,649
2024-02-12,PROD005,Guangzhou,9,326,317
2024-02-13,PROD003,Guangzhou,5,836,831
2024-02-14,PROD012,Guangzhou,4,296,292
2024-02-15,PROD018,Shenzhen,8,971,963
2024-02-16,PROD003,Shanghai,10,938,928
2024-02-17,PROD007,Beijing,3,117,114
2024-02-18,PROD018,Shenzhen,2,963,961
2024-02-19,PROD001,Shanghai,9,812,803
2024-02-20,PROD003,Shenzhen,3,876,873
2024-02-21,PROD015,Beijing,6,667,661
2024-02-22,PROD007,Jilin,10,197,187
2024-02-23,PROD010,Beijing,4,1104,1100
2024-02-24,PROD010,Shanghai,10,438,428
2024-02-25,PROD003,Beijing,8,1108,1100
2024-02-26,PROD009,Shenzhen,4,498,494
2024-02-27,PROD017,Beijing,2,1050,1048
2024-02-28,PROD014,Guangzhou,6,240,234
2024-02-29,PROD012,Beijing,4,860,856
2024-03-01,PROD001,Guangzhou,1,1026,1025
2024-03-02,PROD012,Beijing,1,856,855
2024-03-03,PROD007,Shanghai,3,460,457
2024-03-04,PROD016,Guangzhou,2,233,231
2024-03-05,PROD005,Shenzhen,3,509,506
2024-03-06,PROD002,Shanghai,4,375,371
2024-03-07,PROD013,Shenzhen,5,985,980
2024-03-08,PROD005,Beijing,10,505,495
2024-03-09,PROD003,Beijing,8,1100,1092
2024-03-10,PROD004,Shanghai,8,1059,1051
2024-03-11,PROD009,Beijing,5,356,351
2024-03-12,PROD008,Shenzhen,3,562,559
2024-03-13,PROD017,Beijing,8,1048,1040
2024-03-14,PROD003,Jilin,8,1047,1039
2024-03-15,PROD018,Guangzhou,1,861,860
2024-03-16,PROD002,Beijing,2,768,766
2024-03-17,PROD001,Guangzhou,8,1025,1017
2024-03-18,PROD013,Guangzhou,9,526,517
2024-03-19,PROD013,Jilin,9,672,663
2024-03-20,PROD001,Shenzhen,2,445,443
2024-03-21,PROD019,Shenzhen,4,517,513
2024-03-22,PROD014,Jilin,1,529,528
2024-03-23,PROD009,Shanghai,8,448,440
2024-03-24,PROD005,Shenzhen,3,506,503
2024-03-25,PROD015,Beijing,6,661,655
2024-03-26,PROD006,Beijing,9,785,776
2024-03-27,PROD016,Jilin,9,562,553
2024-03-28,PROD005,Beijing,6,495,489
2024-03-29,PROD012,Guangzhou,10,292,282
2024-03-30,PROD017,Guangzhou,3,246,243
2024-03-31,PROD005,Jilin,8,638,630
2024-04-01,PROD019,Jilin,1,705,704
2024-04-02,PROD003,Guangzhou,7,831,824
2024-04-03,PROD006,Jilin,4,632,628
2024-04-04,PROD016,Shanghai,1,995,994
2024-04-05,PROD007,Jilin,10,187,177
2024-04-06,PROD014,Jilin,9,528,519
2024-04-07,PROD016,Shanghai,3,994,991
2024-04-08,PROD004,Shanghai,4,1051,1047
2024-04-09,PROD001,Shanghai,4,803,799
2024-04-10,PROD011,Shenzhen,1,793,792
2024-04-11,PROD013,Shanghai,8,784,776
2024-04-12,PROD020,Beijing,8,855,847
2024-04-13,PROD004,Shanghai,8,1047,1039
2024-04-14,PROD020,Jilin,4,978,974
2024-04-15,PROD010,Shanghai,2,428,426
2024-04-16,PROD015,Guangzhou,4,553,549
2024-04-17,PROD004,Guangzhou,4,1068,1064
2024-04-18,PROD012,Shenzhen,7,153,146
2024-04-19,PROD004,Jilin,4,195,191
2024-04-20,PROD004,Shanghai,5,1039,1034
2024-04-21,PROD005,Guangzhou,8,317,309
2024-04-22,PROD018,Guangzhou,6,860,854
2024-04-23,PROD020,Jilin,7,974,967
2024-04-24,PROD015,Shenzhen,2,613,611
2024-04-25,PROD019,Guangzhou,4,1006,1002
2024-04-26,PROD012,Beijing,3,855,852
2024-04-27,PROD001,Shenzhen,8,443,435
2024-04-28,PROD013,Shenzhen,10,980,970
2024-04-29,PROD002,Beijing,1,766,765
2024-04-30,PROD016,Beijing,10,969,959
2024-05-01,PROD010,Jilin,10,252,242
2024-05-02,PROD010,Shanghai,10,426,416
2024-05-03,PROD020,Shanghai,1,251,250
2024-05-04,PROD016,Guangzhou,4,231,227
2024-05-05,PROD015,Shenzhen,3,611,608
2024-05-06,PROD003,Guangzhou,3,824,821
2024-05-07,PROD015,Jilin,2,854,852
2024-05-08,PROD012,Guangzhou,2,282,280
2024-05-09,PROD018,Shenzhen,1,961,960
2024-05-10,PROD013,Shenzhen,7,970,963
2024-05-11,PROD013,Jilin,6,663,657
2024-05-12,PROD013,Guangzhou,6,517,511
2024-05-13,PROD010,Shanghai,8,416,408
2024-05-14,PROD004,Guangzhou,7,1064,1057
2024-05-15,PROD008,Shanghai,4,270,266
2024-05-16,PROD009,Guangzhou,8,1063,1055
2024-05-17,PROD018,Beijing,1,734,733
2024-05-18,PROD017,Guangzhou,2,243,241
2024-05-19,PROD018,Shenzhen,2,960,958
2024-05-20,PROD014,Jilin,4,519,515
2024-05-21,PROD019,Jilin,3,704,701
2024-05-22,PROD005,Shanghai,3,688,685
2024-05-23,PROD013,Shanghai,3,776,773
2024-05-24,PROD012,Guangzhou,5,280,275
2024-05-25,PROD007,Beijing,9,114,105
2024-05-26,PROD017,Shanghai,5,615,610
2024-05-27,PROD004,Jilin,8,191,183
2024-05-28,PROD010,Beijing,3,1100,1097
2024-05-29,PROD005,Jilin,10,630,620
2024-05-30,PROD006,Jilin,8,628,620
2024-05-31,PROD002,Jilin,4,654,650
2024-06-01,PROD008,Shenzhen,8,559,551
2024-06-02,PROD001,Shanghai,7,799,792
2024-06-03,PROD001,Beijing,8,177,169
2024-06-04,PROD009,Shanghai,1,440,439
2024-06-05,PROD002,Shenzhen,8,951,943
2024-06-06,PROD013,Jilin,9,657,648
2024-06-07,PROD016,Shanghai,1,991,990
2024-06-08,PROD010,Shanghai,10,408,398
2024-06-09,PROD008,Shanghai,3,266,263
2024-06-10,PROD001,Shenzhen,6,435,429
2024-06-11,PROD001,Beijing,6,169,163
2024-06-12,PROD003,Jilin,9,1039,1030
2024-06-13,PROD008,Guangzhou,5,1106,1101
2024-06-14,PROD009,Shanghai,9,439,430
2024-06-15,PROD007,Shanghai,9,457,448
2024-06-16,PROD006,Beijing,2,776,774
2024-06-17,PROD009,Jilin,7,248,241
2024-06-18,PROD007,Beijing,6,105,99
2024-06-19,PROD008,Guangzhou,7,1101,1094
2024-06-20,PROD002,Beijing,9,765,756
2024-06-21,PROD015,Shenzhen,8,608,600
2024-06-22,PROD015,Shanghai,7,256,249
2024-06-23,PROD006,Guangzhou,8,1035,1027
2024-06-24,PROD001,Guangzhou,1,1017,1016
2024-06-25,PROD001,Shanghai,3,792,789
2024-06-26,PROD008,Shanghai,4,263,259
2024-06-27,PROD019,Beijing,10,512,502
2024-06-28,PROD011,Beijing,3,1213,1210
2024-06-29,PROD019,Shanghai,7,848,841
2024-06-30,PROD003,Guangzhou,10,821,811
2024-07-01,PROD012,Beijing,9,852,843
2024-07-02,PROD019,Shanghai,6,841,835
2024-07-03,PROD004,Guangzhou,9,1057,1048
2024-07-04,PROD007,Jilin,1,177,176
2024-07-05,PROD019,Shenzhen,10,513,503
2024-07-06,PROD012,Jilin,6,722,716
2024-07-07,PROD013,Shanghai,10,773,763
2024-07-08,PROD011,Guangzhou,3,603,600
2024-07-09,PROD014,Jilin,2,515,513
2024-07-10,PROD016,Beijing,8,959,951
2024-07-11,PROD009,Shanghai,6,430,424
2024-07-12,PROD006,Shenzhen,10,226,216
2024-07-13,PROD013,Shenzhen,1,963,962
2024-07-14,PROD013,Jilin,2,648,646
2024-07-15,PROD007,Jilin,5,176,171
2024-07-16,PROD017,Shenzhen,3,649,646
2024-07-17,PROD011,Jilin,10,261,251
2024-07-18,PROD014,Shanghai,1,444,443
2024-07-19,PROD008,Jilin,7,448,441
2024-07-20,PROD019,Jilin,9,701,692
2024-07-21,PROD020,Guangzhou,9,344,335
2024-07-22,PROD020,Shanghai,6,250,244
2024-07-23,PROD014,Shenzhen,3,486,483
2024-07-24,PROD015,Jilin,2,852,850
2024-07-25,PROD020,Guangzhou,9,335,326
2024-07-26,PROD004,Beijing,1,523,522
2024-07-27,PROD019,Guangzhou,6,1002,996
2024-07-28,PROD016,Guangzhou,1,227,226
2024-07-29,PROD012,Jilin,3,716,713
2024-07-30,PROD019,Shanghai,8,835,827
2024-07-31,PROD003,Beijing,5,1092,1087
2024-08-01,PROD015,Beijing,2,655,653
2024-08-02,PROD016,Guangzhou,8,226,218
2024-08-03,PROD008,Shenzhen,5,551,546
2024-08-04,PROD013,Jilin,3,646,643
2024-08-05,PROD008,Jilin,3,441,438
2024-08-06,PROD017,Beijing,10,1040,1030
2024-08-07,PROD010,Beijing,7,1097,1090
2024-08-08,PROD002,Beijing,4,756,752
2024-08-09,PROD019,Shenzhen,6,503,497
2024-08-10,PROD016,Beijing,2,951,949
2024-08-11,PROD016,Shenzhen,9,225,216
2024-08-12,PROD016,Jilin,9,553,544
2024-08-13,PROD019,Beijing,4,502,498
2024-08-14,PROD013,Shanghai,7,763,756
2024-08-15,PROD016,Jilin,4,544,540
2024-08-16,PROD012,Shenzhen,6,146,140
2024-08-17,PROD007,Jilin,5,171,166
2024-08-18,PROD020,Shenzhen,1,933,932
2024-08-19,PROD015,Shanghai,9,249,240
2024-08-20,PROD008,Jilin,9,438,429
2024-08-21,PROD009,Shenzhen,6,494,488
2024-08-22,PROD016,Guangzhou,10,218,208
2024-08-23,PROD017,Jilin,4,949,945
2024-08-24,PROD020,Jilin,1,967,966
2024-08-25,PROD008,Jilin,4,429,425
2024-08-26,PROD013,Guangzhou,8,511,503
2024-08-27,PROD018,Shanghai,6,719,713
2024-08-28,PROD020,Shanghai,3,244,241
2024-08-29,PROD017,Shanghai,7,610,603
2024-08-30,PROD019,Guangzhou,5,996,991
2024-08-31,PROD005,Guangzhou,7,309,302
2024-09-01,PROD013,Shanghai,10,756,746
2024-09-02,PROD018,Beijing,2,733,731
2024-09-03,PROD006,Shenzhen,7,216,209
2024-09-04,PROD019,Beijing,6,498,492
2024-09-05,PROD010,Shanghai,10,398,388
2024-09-06,PROD001,Beijing,6,163,157
2024-09-07,PROD016,Guangzhou,2,208,206
2024-09-08,PROD005,Shanghai,3,685,682
2024-09-09,PROD003,Jilin,6,1030,1024
2024-09-10,PROD016,Shanghai,6,990,984
2024-09-11,PROD001,Beijing,4,157,153
2024-09-12,PROD012,Guangzhou,2,275,273
2024-09-13,PROD015,Beijing,2,653,651
2024-09-14,PROD012,Shenzhen,7,140,133
2024-09-15,PROD010,Jilin,5,242,237
2024-09-16,PROD011,Guangzhou,5,600,595
2024-09-17,PROD015,Guangzhou,8,549,541
2024-09-18,PROD014,Guangzhou,7,234,227
2024-09-19,PROD002,Shenzhen,6,943,937
2024-09-20,PROD001,Shanghai,3,789,786
2024-09-21,PROD006,Beijing,7,774,767
2024-09-22,PROD015,Shanghai,5,240,235
2024-09-23,PROD004,Guangzhou,10,1048,1038
2024-09-24,PROD014,Jilin,2,513,511
2024-09-25,PROD020,Shenzhen,6,932,926
2024-09-26,PROD001,Beijing,1,153,152
2024-09-27,PROD004,Beijing,2,522,520
2024-09-28,PROD018,Shenzhen,1,958,957
2024-09-29,PROD010,Guangzhou,7,1088,1081
2024-09-30,PROD006,Beijing,1,767,766
2024-10-01,PROD013,Shenzhen,5,962,957
2024-10-02,PROD014,Guangzhou,9,227,218
2024-10-03,PROD018,Jilin,10,1207,1197
2024-10-04,PROD016,Guangzhou,9,206,197
2024-10-05,PROD011,Shanghai,7,402,395
2024-10-06,PROD018,Shanghai,6,713,707
2024-10-07,PROD007,Shenzhen,1,397,396
2024-10-08,PROD008,Guangzhou,2,1094,1092
2024-10-09,PROD009,Jilin,4,241,237
2024-10-10,PROD007,Beijing,3,99,96
2024-10-11,PROD012,Jilin,2,713,711
2024-10-12,PROD004,Shenzhen,8,323,315
2024-10-13,PROD012,Jilin,1,711,710
2024-10-14,PROD009,Beijing,8,351,343
2024-10-15,PROD018,Shanghai,6,707,701
2024-10-16,PROD011,Shenzhen,8,792,784
2024-10-17,PROD019,Shenzhen,2,497,495
2024-10-18,PROD011,Shanghai,10,395,385
2024-10-19,PROD006,Shanghai,9,211,202
2024-10-20,PROD014,Shanghai,5,443,438
2024-10-21,PROD014,Shenzhen,10,483,473
2024-10-22,PROD013,Jilin,6,643,637
2024-10-23,PROD014,Shenzhen,9,473,464
2024-10-24,PROD009,Shenzhen,6,488,482
2024-10-25,PROD015,Shanghai,9,235,226
2024-10-26,PROD012,Shanghai,7,709,702
2024-10-27,PROD007,Jilin,8,166,158
2024-10-28,PROD017,Beijing,8,1030,1022
2024-10-29,PROD014,Guangzhou,9,218,209
2024-10-30,PROD013,Beijing,4,973,969
2024-10-31,PROD003,Shenzhen,8,873,865
2024-11-01,PROD018,Jilin,9,1197,1188
2024-11-02,PROD020,Jilin,1,966,965
2024-11-03,PROD018,Beijing,1,731,730
2024-11-04,PROD016,Guangzhou,5,197,192
2024-11-05,PROD012,Jilin,3,710,707
2024-11-06,PROD015,Shenzhen,9,600,591
2024-11-07,PROD014,Jilin,7,511,504
2024-11-08,PROD006,Shenzhen,6,209,203
2024-11-09,PROD011,Beijing,3,1210,1207
2024-11-10,PROD009,Beijing,9,343,334
2024-11-11,PROD013,Jilin,10,637,627
2024-11-12,PROD010,Beijing,7,1090,1083
2024-11-13,PROD014,Guangzhou,10,209,199
2024-11-14,PROD010,Beijing,5,1083,1078
2024-11-15,PROD009,Guangzhou,9,1055,1046
2024-11-16,PROD014,Shenzhen,3,464,461
2024-11-17,PROD004,Guangzhou,2,1038,1036
2024-11-18,PROD018,Shanghai,10,701,691
2024-11-19,PROD010,Jilin,7,237,230
2024-11-20,PROD017,Guangzhou,5,241,236
2024-11-21,PROD010,Jilin,4,230,226
2024-11-22,PROD010,Jilin,1,226,225
2024-11-23,PROD014,Shenzhen,8,461,453
2024-11-24,PROD010,Beijing,7,1078,1071
2024-11-25,PROD004,Guangzhou,6,1036,1030
2024-11-26,PROD002,Shenzhen,8,937,929
2024-11-27,PROD001,Shanghai,1,786,785
2024-11-28,PROD019,Jilin,4,692,688
2024-11-29,PROD002,Guangzhou,7,790,783
2024-11-30,PROD012,Beijing,8,843,835
2024-12-01,PROD018,Shenzhen,6,957,951
2024-12-02,PROD013,Beijing,3,969,966
2024-12-03,PROD008,Shanghai,7,259,252
2024-12-04,PROD017,Jilin,8,945,937
2024-12-05,PROD005,Jilin,7,620,613
2024-12-06,PROD019,Shanghai,8,827,819
2024-12-07,PROD007,Jilin,6,158,152
2024-12-08,PROD008,Beijing,3,344,341
2024-12-09,PROD003,Shenzhen,9,865,856
2024-12-10,PROD011,Shanghai,2,385,383
2024-12-11,PROD001,Guangzhou,4,1016,1012
2024-12-12,PROD012,Shenzhen,8,133,125
2024-12-13,PROD019,Beijing,9,492,483
2024-12-14,PROD012,Shenzhen,10,125,115
2024-12-15,PROD006,Shenzhen,2,203,201
2024-12-16,PROD018,Beijing,10,730,720
2024-12-17,PROD006,Shanghai,8,202,194
2024-12-18,PROD003,Guangzhou,4,811,807
2024-12-19,PROD015,Shanghai,5,226,221
2024-12-20,PROD012,Shanghai,7,702,695
2024-12-21,PROD019,Beijing,10,483,473
2024-12-22,PROD014,Beijing,8,371,363
2024-12-23,PROD018,Beijing,7,720,713
2024-12-24,PROD007,Guangzhou,5,830,825
2024-12-25,PROD013,Beijing,5,966,961
2024-12-26,PROD018,Jilin,9,1188,1179
2024-12-27,PROD011,Jilin,9,251,242
2024-12-28,PROD010,Beijing,1,1071,1070
2024-12-29,PROD014,Shanghai,4,438,434
2024-12-30,PROD010,Beijing,7,1070,1063
2024-01-01,PROD007,Shanghai,9,448,439
2024-01-02,PROD006,Jilin,1,620,619
2024-01-03,PROD018,Jilin,5,1179,1174
2024-01-04,PROD010,Beijing,6,1063,1057
2024-01-05,PROD005,Shanghai,1,682,681
2024-01-06,PROD002,Guangzhou,1,783,782
2024-01-07,PROD002,Shanghai,6,371,365
2024-01-08,PROD008,Shanghai,3,252,249
2024-01-09,PROD016,Shanghai,5,984,979
2024-01-10,PROD020,Beijing,3,847,844
2024-01-11,PROD017,Guangzhou,4,236,232
2024-01-12,PROD009,Shanghai,8,424,416
2024-01-13,PROD012,Guangzhou,2,273,271
2024-01-14,PROD019,Shanghai,8,819,811
2024-01-15,PROD014,Shenzhen,9,453,444
2024-01-16,PROD018,Guangzhou,8,854,846
2024-01-17,PROD006,Shenzhen,5,201,196
2024-01-18,PROD013,Beijing,1,961,960
2024-01-19,PROD014,Shanghai,10,434,424
2024-01-20,PROD006,Shenzhen,10,196,186
2024-01-21,PROD007,Jilin,1,152,151
2024-01-22,PROD003,Shanghai,9,928,919
2024-01-23,PROD008,Beijing,1,341,340
2024-01-24,PROD003,Guangzhou,6,807,801
2024-01-25,PROD008,Guangzhou,5,1092,1087
2024-01-26,PROD017,Beijing,8,1022,1014
2024-01-27,PROD019,Shenzhen,3,495,492
2024-01-28,PROD010,Guangzhou,2,1081,1079
2024-01-29,PROD014,Guangzhou,7,199,192
2024-01-30,PROD001,Guangzhou,10,1012,1002
2024-01-31,PROD006,Shanghai,8,194,186
2024-02-01,PROD018,Guangzhou,7,846,839
2024-02-02,PROD006,Guangzhou,10,1027,1017
2024-02-03,PROD010,Jilin,4,225,221
2024-02-04,PROD001,Guangzhou,1,1002,1001
2024-02-05,PROD008,Beijing,7,340,333
2024-02-06,PROD010,Beijing,3,1057,1054
2024-02-07,PROD017,Shanghai,8,603,595
2024-02-08,PROD017,Shenzhen,8,646,638
2024-02-09,PROD012,Shenzhen,10,115,105
2024-02-10,PROD015,Guangzhou,7,541,534
2024-02-11,PROD008,Shenzhen,9,546,537
2024-02-12,PROD005,Shenzhen,1,503,502
2024-02-13,PROD005,Shanghai,8,681,673
2024-02-14,PROD009,Guangzhou,2,1046,1044
2024-02-15,PROD016,Shenzhen,1,216,215
2024-02-16,PROD009,Jilin,3,237,234
2024-02-17,PROD017,Beijing,3,1014,1011
2024-02-18,PROD009,Guangzhou,1,1044,1043
2024-02-19,PROD010,Beijing,7,1054,1047
2024-02-20,PROD012,Beijing,7,835,828
2024-02-21,PROD006,Jilin,7,619,612
2024-02-22,PROD014,Jilin,4,504,500
2024-02-23,PROD020,Jilin,8,965,957
2024-02-24,PROD014,Beijing,8,363,355
2024-02-25,PROD004,Beijing,10,520,510
2024-02-26,PROD007,Guangzhou,3,825,822
2024-02-27,PROD008,Beijing,1,333,332
2024-02-28,PROD005,Jilin,1,613,612
2024-02-29,PROD019,Jilin,5,688,683
2024-03-01,PROD001,Jilin,10,372,362
2024-03-02,PROD008,Shanghai,8,249,241
2024-03-03,PROD008,Guangzhou,5,1087,1082
2024-03-04,PROD018,Beijing,9,713,704
2024-03-05,PROD005,Shenzhen,4,502,498
2024-03-06,PROD003,Shenzhen,10,856,846
2024-03-07,PROD017,Jilin,10,937,927
2024-03-08,PROD006,Jilin,6,612,606
2024-03-09,PROD015,Guangzhou,7,534,527
2024-03-10,PROD020,Shanghai,3,241,238
2024-03-11,PROD011,Guangzhou,4,595,591
2024-03-12,PROD006,Shenzhen,6,186,180
2024-03-13,PROD003,Guangzhou,7,801,794
2024-03-14,PROD004,Guangzhou,3,1030,1027
2024-03-15,PROD001,Guangzhou,10,1001,991
2024-03-16,PROD009,Shenzhen,6,482,476
2024-03-17,PROD005,Guangzhou,9,302,293
2024-03-18,PROD019,Jilin,4,683,679
2024-03-19,PROD019,Guangzhou,5,991,986
2024-03-20,PROD013,Shanghai,2,746,744
2024-03-21,PROD016,Beijing,8,949,941
2024-03-22,PROD012,Guangzhou,9,271,262
2024-03-23,PROD002,Shanghai,5,365,360
2024-03-24,PROD018,Beijing,4,704,700
2024-03-25,PROD011,Guangzhou,10,591,581
2024-03-26,PROD015,Jilin,7,850,843
2024-03-27,PROD002,Guangzhou,7,782,775
2024-03-28,PROD006,Jilin,1,606,605
2024-03-29,PROD004,Beijing,5,510,505
2024-03-30,PROD010,Beijing,8,1047,1039
2024-03-31,PROD014,Jilin,6,500,494
2024-04-01,PROD001,Shenzhen,9,429,420
2024-04-02,PROD009,Guangzhou,4,1043,1039
2024-04-03,PROD005,Jilin,6,612,606
2024-04-04,PROD013,Shenzhen,3,957,954
2024-04-05,PROD018,Jilin,1,1174,1173
2024-04-06,PROD006,Beijing,1,766,765
2024-04-07,PROD002,Jilin,10,650,640
2024-04-08,PROD014,Guangzhou,7,192,185
2024-04-09,PROD007,Guangzhou,3,822,819
2024-04-10,PROD020,Beijing,7,844,837
2024-04-11,PROD008,Shenzhen,2,537,535
2024-04-12,PROD019,Shanghai,3,811,808
2024-04-13,PROD002,Guangzhou,1,775,774
2024-04-14,PROD013,Beijing,1,960,959
2024-04-15,PROD013,Jilin,9,627,618
2024-04-16,PROD016,Beijing,7,941,934
2024-04-17,PROD020,Jilin,6,957,951
2024-04-18,PROD009,Shenzhen,4,476,472
2024-04-19,PROD003,Guangzhou,4,794,790
2024-04-20,PROD008,Shanghai,3,241,238
2024-04-21,PROD018,Jilin,6,1173,1167
2024-04-22,PROD005,Beijing,2,489,487
2024-04-23,PROD007,Guangzhou,7,819,812
2024-04-24,PROD018,Guangzhou,4,839,835
2024-04-25,PROD011,Beijing,5,1207,1202
2024-04-26,PROD005,Shenzhen,4,498,494
2024-04-27,PROD012,Beijing,5,828,823
2024-04-28,PROD009,Beijing,5,334,329
2024-04-29,PROD016,Beijing,8,934,926
2024-04-30,PROD006,Jilin,6,605,599
2024-05-01,PROD004,Shenzhen,4,315,311
2024-05-02,PROD011,Beijing,2,1202,1200
2024-05-03,PROD018,Shanghai,4,691,687
2024-05-04,PROD005,Beijing,9,487,478
2024-05-05,PROD016,Beijing,4,926,922
2024-05-06,PROD017,Shanghai,10,595,585
2024-05-07,PROD014,Shanghai,2,424,422
2024-05-08,PROD007,Guangzhou,8,812,804
2024-05-09,PROD002,Shenzhen,8,929,921
2024-05-10,PROD009,Shenzhen,4,472,468
2024-05-11,PROD005,Jilin,3,606,603
2024-05-12,PROD004,Beijing,3,505,502
2024-05-13,PROD010,Guangzhou,10,1079,1069
2024-05-14,PROD011,Shanghai,8,383,375
2024-05-15,PROD019,Beijing,6,473,467
2024-05-16,PROD018,Beijing,3,700,697
2024-05-17,PROD012,Shenzhen,6,105,99
2024-05-18,PROD008,Shenzhen,3,535,532
2024-05-19,PROD017,Jilin,9,927,918
2024-05-20,PROD014,Beijing,3,355,352
2024-05-21,PROD016,Shanghai,10,979,969
2024-05-22,PROD014,Guangzhou,9,185,176
2024-05-23,PROD007,Guangzhou,10,804,794
2024-05-24,PROD013,Shanghai,8,744,736
2024-05-25,PROD010,Shanghai,7,388,381
2024-05-26,PROD007,Beijing,7,96,89
2024-05-27,PROD011,Beijing,5,1200,1195
2024-05-28,PROD008,Shenzhen,9,532,523
2024-05-29,PROD014,Jilin,6,494,488
2024-05-30,PROD001,Guangzhou,9,991,982
2024-05-31,PROD003,Shanghai,9,919,910
2024-06-01,PROD018,Jilin,10,1167,1157
2024-06-02,PROD002,Shenzhen,7,921,914
2024-06-03,PROD017,Beijing,5,1011,1006
2024-06-04,PROD015,Shanghai,7,221,214
2024-06-05,PROD008,Jilin,5,425,420
2024-06-06,PROD016,Shenzhen,4,215,211
2024-06-07,PROD014,Guangzhou,8,176,168
2024-06-08,PROD008,Beijing,6,332,326
2024-06-09,PROD014,Shanghai,2,422,420
2024-06-10,PROD005,Shanghai,8,673,665
2024-06-11,PROD005,Jilin,2,603,601
2024-06-12,PROD005,Jilin,9,601,592
2024-06-13,PROD009,Shenzhen,1,468,467
2024-06-14,PROD002,Jilin,4,640,636
2024-06-15,PROD004,Jilin,3,183,180
2024-06-16,PROD015,Jilin,8,843,835
2024-06-17,PROD006,Beijing,4,765,761
2024-06-18,PROD011,Shenzhen,10,784,774
2024-06-19,PROD016,Shanghai,5,969,964
2024-06-20,PROD011,Shanghai,2,375,373
2024-06-21,PROD016,Shenzhen,8,211,203
2024-06-22,PROD004,Shenzhen,10,311,301
2024-06-23,PROD014,Beijing,6,352,346
2024-06-24,PROD003,Guangzhou,1,790,789
2024-06-25,PROD012,Beijing,7,823,816
2024-06-26,PROD015,Jilin,6,835,829
2024-06-27,PROD001,Shanghai,7,785,778
2024-06-28,PROD017,Jilin,10,918,908
2024-06-29,PROD017,Shenzhen,4,638,634
2024-06-30,PROD006,Beijing,3,761,758
2024-07-01,PROD008,Jilin,2,420,418
2024-07-02,PROD017,Shanghai,9,585,576
2024-07-03,PROD010,Beijing,4,1039,1035
2024-07-04,PROD018,Shanghai,7,687,680
2024-07-05,PROD014,Shanghai,5,420,415
2024-07-06,PROD001,Beijing,7,152,145
2024-07-07,PROD014,Shenzhen,5,444,439
2024-07-08,PROD013,Shanghai,9,736,727
2024-07-09,PROD004,Guangzhou,9,1027,1018
2024-07-10,PROD015,Shenzhen,3,591,588
2024-07-11,PROD002,Shenzhen,6,914,908
2024-07-12,PROD003,Beijing,3,1087,1084
2024-07-13,PROD010,Guangzhou,8,1069,1061
2024-07-14,PROD017,Jilin,1,908,907
2024-07-15,PROD008,Jilin,6,418,412
2024-07-16,PROD011,Shenzhen,7,774,767
2024-07-17,PROD008,Guangzhou,2,1082,1080
2024-07-18,PROD015,Guangzhou,4,527,523
2024-07-19,PROD007,Shanghai,10,439,429
2024-07-20,PROD016,Shenzhen,10,203,193
2024-07-21,PROD015,Shanghai,2,214,212
2024-07-22,PROD020,Beijing,10,837,827
2024-07-23,PROD010,Shenzhen,8,695,687
2024-07-24,PROD003,Guangzhou,4,789,785
2024-07-25,PROD005,Jilin,5,592,587
2024-07-26,PROD012,Shenzhen,9,99,90
2024-07-27,PROD013,Jilin,4,618,614
2024-07-28,PROD001,Guangzhou,1,982,981
2024-07-29,PROD006,Shenzhen,5,180,175
2024-07-30,PROD015,Beijing,7,651,644
2024-07-31,PROD003,Shanghai,1,910,909
2024-08-01,PROD004,Guangzhou,6,1018,1012
2024-08-02,PROD018,Shanghai,3,680,677
2024-08-03,PROD001,Beijing,2,145,143
2024-08-04,PROD006,Jilin,3,599,596
2024-08-05,PROD008,Beijing,5,326,321
2024-08-06,PROD020,Jilin,10,951,941
2024-08-07,PROD010,Shanghai,3,381,378
2024-08-08,PROD020,Shanghai,3,238,235
2024-08-09,PROD008,Guangzhou,4,1080,1076
2024-08-10,PROD002,Shenzhen,1,908,907
2024-08-11,PROD018,Shenzhen,6,951,945
2024-08-12,PROD004,Guangzhou,9,1012,1003
2024-08-13,PROD005,Shenzhen,4,494,490
2024-08-14,PROD009,Beijing,3,329,326
2024-08-15,PROD003,Jilin,1,1024,1023
2024-08-16,PROD017,Beijing,9,1006,997
2024-08-17,PROD003,Shenzhen,7,846,839
2024-08-18,PROD016,Shanghai,9,964,955
2024-08-19,PROD006,Shanghai,7,186,179
2024-08-20,PROD003,Shenzhen,4,839,835
2024-08-21,PROD018,Shanghai,5,677,672
2024-08-22,PROD001,Jilin,2,362,360
2024-08-23,PROD003,Guangzhou,9,785,776
2024-08-24,PROD002,Shanghai,3,360,357
2024-08-25,PROD016,Shanghai,4,955,951
2024-08-26,PROD007,Guangzhou,1,794,793
2024-08-27,PROD018,Beijing,2,697,695
2024-08-28,PROD015,Shenzhen,1,588,587
2024-08-29,PROD017,Shenzhen,8,634,626
2024-08-30,PROD016,Beijing,4,922,918
2024-08-31,PROD006,Shenzhen,4,175,171
2024-09-01,PROD008,Shenzhen,5,523,518
2024-09-02,PROD018,Jilin,5,1157,1152
2024-09-03,PROD009,Shanghai,5,416,411
2024-09-04,PROD004,Beijing,8,502,494
2024-09-05,PROD011,Beijing,1,1195,1194
2024-09-06,PROD009,Jilin,9,234,225
2024-09-07,PROD013,Guangzhou,9,503,494
2024-09-08,PROD007,Shanghai,1,429,428
2024-09-09,PROD002,Guangzhou,4,774,770
2024-09-10,PROD015,Guangzhou,7,523,516
2024-09-11,PROD003,Shenzhen,4,835,831
2024-09-12,PROD020,Beijing,8,827,819
2024-09-13,PROD020,Guangzhou,5,326,321
2024-09-14,PROD019,Guangzhou,3,986,983
2024-09-15,PROD019,Shenzhen,6,492,486
2024-09-16,PROD002,Shanghai,5,357,352
2024-09-17,PROD004,Guangzhou,5,1003,998
2024-09-18,PROD020,Shenzhen,4,926,922
2024-09-19,PROD013,Guangzhou,6,494,488
2024-09-20,PROD017,Beijing,7,997,990
2024-09-21,PROD011,Guangzhou,9,581,572
2024-09-22,PROD018,Beijing,4,695,691
2024-09-23,PROD005,Guangzhou,1,293,292
2024-09-24,PROD012,Jilin,7,707,700
2024-09-25,PROD018,Shenzhen,10,945,935
2024-09-26,PROD015,Guangzhou,4,516,512
2024-09-27,PROD002,Shenzhen,4,907,903
2024-09-28,PROD016,Beijing,1,918,917
2024-09-29,PROD005,Shanghai,4,665,661
2024-09-30,PROD019,Shanghai,1,808,807
2024-10-01,PROD013,Shenzhen,9,954,945
2024-10-02,PROD002,Jilin,7,636,629
2024-10-03,PROD010,Jilin,4,221,217
2024-10-04,PROD006,Shenzhen,10,171,161
2024-10-05,PROD007,Shenzhen,8,396,388
2024-10-06,PROD004,Shanghai,3,1034,1031
2024-10-07,PROD017,Shanghai,3,576,573
2024-10-08,PROD020,Shanghai,4,235,231
2024-10-09,PROD006,Guangzhou,2,1017,1015
2024-10-10,PROD006,Shenzhen,3,161,158
2024-10-11,PROD017,Jilin,5,907,902
2024-10-12,PROD011,Jilin,1,242,241
2024-10-13,PROD008,Guangzhou,4,1076,1072
2024-10-14,PROD006,Shenzhen,8,158,150
2024-10-15,PROD001,Shenzhen,6,420,414
2024-10-16,PROD007,Beijing,5,89,84
2024-10-17,PROD020,Shenzhen,10,922,912
2024-10-18,PROD004,Shanghai,10,1031,1021
2024-10-19,PROD014,Jilin,10,488,478
2024-10-20,PROD018,Jilin,1,1152,1151
2024-10-21,PROD013,Beijing,1,959,958
2024-10-22,PROD013,Shanghai,3,727,724
2024-10-23,PROD010,Shanghai,5,378,373
2024-10-24,PROD005,Guangzhou,1,292,291
2024-10-25,PROD012,Jilin,10,700,690
2024-10-26,PROD010,Beijing,6,1035,1029
2024-10-27,PROD019,Beijing,4,467,463
2024-10-28,PROD003,Jilin,5,1023,1018
2024-10-29,PROD002,Beijing,7,752,745
2024-10-30,PROD004,Beijing,4,494,490
2024-10-31,PROD008,Guangzhou,7,1072,1065
2024-11-01,PROD019,Beijing,10,463,453
2024-11-02,PROD020,Shanghai,8,231,223
2024-11-03,PROD002,Guangzhou,4,770,766
2024-11-04,PROD010,Beijing,4,1029,1025
2024-11-05,PROD007,Shanghai,1,428,427
2024-11-06,PROD017,Shanghai,10,573,563
2024-11-07,PROD008,Beijing,9,321,312
2024-11-08,PROD003,Guangzhou,8,776,768
2024-11-09,PROD011,Guangzhou,5,572,567
2024-11-10,PROD006,Beijing,10,758,748
2024-11-11,PROD014,Shenzhen,1,439,438
2024-11-12,PROD020,Jilin,3,941,938
2024-11-13,PROD004,Shanghai,3,1021,1018
2024-11-14,PROD008,Beijing,6,312,306
2024-11-15,PROD014,Shenzhen,4,438,434
2024-11-16,PROD016,Guangzhou,5,192,187
2024-11-17,PROD016,Jilin,6,540,534
2024-11-18,PROD019,Shanghai,3,807,804
2024-11-19,PROD018,Beijing,2,691,689
2024-11-20,PROD019,Guangzhou,2,983,981
2024-11-21,PROD013,Shanghai,7,724,717
2024-11-22,PROD017,Guangzhou,10,232,222
2024-11-23,PROD016,Shanghai,2,951,949
2024-11-24,PROD019,Beijing,4,453,449
2024-11-25,PROD012,Shanghai,10,695,685
2024-11-26,PROD006,Shanghai,2,179,177
2024-11-27,PROD014,Guangzhou,7,168,161
2024-11-28,PROD003,Guangzhou,3,768,765
2024-11-29,PROD010,Shenzhen,4,687,683
2024-11-30,PROD018,Guangzhou,1,835,834
2024-12-01,PROD020,Guangzhou,8,321,313
2024-12-02,PROD016,Shenzhen,4,193,189
2024-12-03,PROD001,Shanghai,9,778,769
2024-12-04,PROD004,Beijing,2,490,488
2024-12-05,PROD009,Guangzhou,8,1039,1031
2024-12-06,PROD019,Beijing,7,449,442
2024-12-07,PROD005,Jilin,2,587,585
2024-12-08,PROD006,Shenzhen,4,150,146
2024-12-09,PROD010,Jilin,1,217,216
2024-12-10,PROD009,Guangzhou,5,1031,1026
2024-12-11,PROD016,Shanghai,5,949,944
2024-12-12,PROD011,Guangzhou,10,567,557
2024-12-13,PROD005,Shenzhen,5,490,485
2024-12-14,PROD017,Shenzhen,4,626,622
2024-12-15,PROD002,Guangzhou,3,766,763
2024-12-16,PROD005,Jilin,2,585,583
2024-12-17,PROD017,Beijing,7,990,983
2024-12-18,PROD016,Shenzhen,8,189,181
2024-12-19,PROD011,Shenzhen,9,767,758
2024-12-20,PROD019,Guangzhou,2,981,979
2024-12-21,PROD018,Guangzhou,9,834,825
2024-12-22,PROD007,Shenzhen,2,388,386
2024-12-23,PROD019,Jilin,5,679,674
2024-12-24,PROD013,Shanghai,9,717,708
2024-12-25,PROD011,Shanghai,1,373,372
2024-12-26,PROD015,Jilin,7,829,822
2024-12-27,PROD004,Shanghai,8,1018,1010
2024-12-28,PROD003,Guangzhou,6,765,759
2024-12-29,PROD003,Jilin,4,1018,1014
2024-12-30,PROD001,Guangzhou,4,981,977
2024-01-01,PROD018,Beijing,3,689,686
2024-01-02,PROD004,Shanghai,4,1010,1006
2024-01-03,PROD011,Guangzhou,1,557,556
2024-01-04,PROD012,Shanghai,5,685,680
2024-01-05,PROD002,Shanghai,1,352,351
2024-01-06,PROD001,Shanghai,6,769,763
2024-01-07,PROD001,Beijing,4,143,139
2024-01-08,PROD010,Shanghai,7,373,366
2024-01-09,PROD020,Beijing,7,819,812
2024-01-10,PROD004,Shenzhen,4,301,297
2024-01-11,PROD011,Shanghai,5,372,367
2024-01-12,PROD007,Jilin,5,151,146
2024-01-13,PROD019,Guangzhou,4,979,975
2024-01-14,PROD001,Beijing,8,139,131
2024-01-15,PROD008,Shanghai,5,238,233
2024-01-16,PROD011,Shanghai,3,367,364
2024-01-17,PROD006,Guangzhou,3,1015,1012
2024-01-18,PROD011,Jilin,5,241,236
2024-01-19,PROD006,Shenzhen,8,146,138
2024-01-20,PROD001,Shanghai,8,763,755
2024-01-21,PROD011,Beijing,4,1194,1190
2024-01-22,PROD007,Shanghai,1,427,426
2024-01-23,PROD002,Beijing,8,745,737
2024-01-24,PROD017,Guangzhou,10,222,212
2024-01-25,PROD011,Jilin,10,236,226
2024-01-26,PROD007,Shanghai,2,426,424
2024-01-27,PROD015,Guangzhou,10,512,502
2024-01-28,PROD013,Shenzhen,6,945,939
2024-01-29,PROD010,Shenzhen,9,683,674
2024-01-30,PROD015,Beijing,10,644,634
2024-01-31,PROD003,Shenzhen,9,831,822
2024-02-01,PROD006,Guangzhou,2,1012,1010
2024-02-02,PROD009,Beijing,1,326,325
2024-02-03,PROD002,Shanghai,3,351,348
2024-02-04,PROD018,Shanghai,5,672,667
2024-02-05,PROD017,Guangzhou,8,212,204
2024-02-06,PROD006,Shanghai,3,177,174
2024-02-07,PROD002,Guangzhou,4,763,759
2024-02-08,PROD004,Jilin,3,180,177
2024-02-09,PROD005,Guangzhou,5,291,286
2024-02-10,PROD004,Jilin,5,177,172
2024-02-11,PROD007,Guangzhou,3,793,790
2024-02-12,PROD008,Guangzhou,3,1065,1062
2024-02-13,PROD011,Beijing,2,1190,1188
2024-02-14,PROD017,Guangzhou,4,204,200
2024-02-15,PROD019,Shenzhen,4,486,482
2024-02-16,PROD002,Shenzhen,10,903,893
2024-02-17,PROD006,Guangzhou,8,1010,1002
2024-02-18,PROD019,Shenzhen,3,482,479
2024-02-19,PROD020,Jilin,2,938,936
2024-02-20,PROD012,Jilin,3,690,687
2024-02-21,PROD008,Shanghai,8,233,225
2024-02-22,PROD007,Shanghai,3,424,421
2024-02-23,PROD012,Guangzhou,3,262,259
2024-02-24,PROD013,Jilin,1,614,613
2024-02-25,PROD016,Shenzhen,2,181,179
2024-02-26,PROD012,Shenzhen,5,90,85
2024-02-27,PROD007,Shanghai,9,421,412
2024-02-28,PROD005,Jilin,5,583,578
2024-02-29,PROD019,Beijing,5,442,437
2024-03-01,PROD002,Jilin,3,629,626
2024-03-02,PROD020,Beijing,3,812,809
2024-03-03,PROD018,Jilin,10,1151,1141
2024-03-04,PROD005,Shenzhen,8,485,477
2024-03-05,PROD002,Jilin,5,626,621
2024-03-06,PROD012,Shanghai,2,680,678
2024-03-07,PROD016,Shanghai,3,944,941
2024-03-08,PROD013,Guangzhou,2,488,486
2024-03-09,PROD011,Guangzhou,7,556,549
2024-03-10,PROD002,Beijing,1,737,736
2024-03-11,PROD020,Beijing,10,809,799
2024-03-12,PROD010,Guangzhou,2,1061,1059
2024-03-13,PROD016,Shenzhen,4,179,175
2024-03-14,PROD008,Guangzhou,4,1062,1058
2024-03-15,PROD016,Jilin,9,534,525
2024-03-16,PROD004,Guangzhou,4,998,994
2024-03-17,PROD020,Shanghai,2,223,221
2024-03-18,PROD015,Shenzhen,2,587,585
2024-03-19,PROD006,Shanghai,2,174,172
2024-03-20,PROD010,Jilin,4,216,212
2024-03-21,PROD019,Jilin,3,674,671
2024-03-22,PROD014,Guangzhou,9,161,152
2024-03-23,PROD014,Jilin,4,478,474
2024-03-24,PROD004,Shenzhen,10,297,287
2024-03-25,PROD005,Shenzhen,8,477,469
2024-03-26,PROD005,Shenzhen,7,469,462
2024-03-27,PROD009,Beijing,9,325,316
2024-03-28,PROD006,Shenzhen,5,138,133
2024-03-29,PROD011,Shenzhen,8,758,750
2024-03-30,PROD014,Guangzhou,9,152,143
2024-03-31,PROD007,Shanghai,10,412,402
2024-04-01,PROD011,Jilin,6,226,220
2024-04-02,PROD007,Shanghai,8,402,394
2024-04-03,PROD005,Guangzhou,6,286,280
2024-04-04,PROD018,Guangzhou,9,825,816
2024-04-05,PROD014,Guangzhou,4,143,139
2024-04-06,PROD020,Shanghai,9,221,212
2024-04-07,PROD004,Shanghai,1,1006,1005
2024-04-08,PROD006,Beijing,4,748,744
2024-04-09,PROD014,Beijing,6,346,340
2024-04-10,PROD005,Beijing,3,478,475
2024-04-11,PROD016,Guangzhou,9,187,178
2024-04-12,PROD011,Jilin,7,220,213
2024-04-13,PROD001,Shenzhen,7,414,407
2024-04-14,PROD011,Shenzhen,5,750,745
2024-04-15,PROD003,Guangzhou,8,759,751
2024-04-16,PROD016,Shenzhen,3,175,172
2024-04-17,PROD008,Guangzhou,1,1058,1057
2024-04-18,PROD015,Jilin,2,822,820
2024-04-19,PROD001,Beijing,3,131,128
2024-04-20,PROD013,Jilin,10,613,603
2024-04-21,PROD020,Shenzhen,6,912,906
2024-04-22,PROD013,Jilin,7,603,596
2024-04-23,PROD003,Shenzhen,2,822,820
2024-04-24,PROD005,Beijing,4,475,471
2024-04-25,PROD003,Shenzhen,3,820,817
2024-04-26,PROD003,Beijing,5,1084,1079
2024-04-27,PROD012,Guangzhou,7,259,252
2024-04-28,PROD004,Guangzhou,8,994,986
2024-04-29,PROD005,Beijing,10,471,461
2024-04-30,PROD005,Jilin,3,578,575
2024-05-01,PROD020,Shenzhen,9,906,897
2024-05-02,PROD013,Shanghai,8,708,700
2024-05-03,PROD002,Shenzhen,3,893,890
2024-05-04,PROD002,Jilin,6,621,615
2024-05-05,PROD004,Shanghai,1,1005,1004
2024-05-06,PROD020,Guangzhou,2,313,311
2024-05-07,PROD008,Shenzhen,4,518,514
2024-05-08,PROD012,Shanghai,2,678,676
2024-05-09,PROD015,Guangzhou,2,502,500
2024-05-10,PROD014,Shanghai,5,415,410
2024-05-11,PROD005,Guangzhou,5,280,275
2024-05-12,PROD020,Shenzhen,4,897,893
2024-05-13,PROD017,Shenzhen,1,622,621
2024-05-14,PROD003,Shanghai,5,909,904
2024-05-15,PROD002,Shenzhen,2,890,888
2024-05-16,PROD003,Jilin,6,1014,1008
2024-05-17,PROD020,Shenzhen,8,893,885
2024-05-18,PROD006,Beijing,6,744,738
2024-05-19,PROD010,Shanghai,5,366,361
2024-05-20,PROD007,Jilin,7,146,139
2024-05-21,PROD015,Guangzhou,6,500,494
2024-05-22,PROD010,Guangzhou,2,1059,1057
2024-05-23,PROD007,Shenzhen,5,386,381
2024-05-24,PROD005,Beijing,9,461,452
2024-05-25,PROD018,Shenzhen,6,935,929
2024-05-26,PROD014,Jilin,7,474,467
2024-05-27,PROD008,Shanghai,6,225,219
2024-05-28,PROD006,Shenzhen,2,133,131
2024-05-29,PROD014,Jilin,5,467,462
2024-05-30,PROD003,Guangzhou,10,751,741
2024-05-31,PROD011,Beijing,2,1188,1186
2024-06-01,PROD005,Shenzhen,8,462,454
2024-06-02,PROD016,Shenzhen,9,172,163
2024-06-03,PROD017,Guangzhou,4,200,196
2024-06-04,PROD011,Shenzhen,3,745,742
2024-06-05,PROD018,Guangzhou,10,816,806
2024-06-06,PROD018,Shanghai,2,667,665
2024-06-07,PROD008,Beijing,5,306,301
2024-06-08,PROD001,Beijing,8,128,120
2024-06-09,PROD005,Shanghai,7,661,654
2024-06-10,PROD006,Guangzhou,3,1002,999
2024-06-11,PROD003,Beijing,7,1079,1072
2024-06-12,PROD020,Jilin,8,936,928
2024-06-13,PROD014,Beijing,1,340,339
2024-06-14,PROD018,Beijing,5,686,681
2024-06-15,PROD009,Jilin,4,225,221
2024-06-16,PROD002,Shanghai,5,348,343
2024-06-17,PROD010,Jilin,10,212,202
2024-06-18,PROD014,Jilin,8,462,454
2024-06-19,PROD007,Beijing,9,84,75
2024-06-20,PROD019,Shenzhen,9,479,470
2024-06-21,PROD009,Shanghai,3,411,408
2024-06-22,PROD003,Shenzhen,8,817,809
2024-06-23,PROD003,Guangzhou,2,741,739
2024-06-24,PROD013,Shenzhen,3,939,936
2024-06-25,PROD007,Shenzhen,10,381,371
2024-06-26,PROD019,Shenzhen,9,470,461
2024-06-27,PROD009,Shenzhen,1,467,466
2024-06-28,PROD015,Beijing,5,634,629
2024-06-29,PROD010,Guangzhou,2,1057,1055
2024-06-30,PROD008,Jilin,2,412,410
2024-07-01,PROD013,Shanghai,7,700,693
2024-07-02,PROD019,Guangzhou,1,975,974
2024-07-03,PROD013,Beijing,1,958,957
2024-07-04,PROD017,Jilin,6,902,896
2024-07-05,PROD001,Guangzhou,9,977,968
2024-07-06,PROD008,Beijing,5,301,296
2024-07-07,PROD017,Shanghai,1,563,562
2024-07-08,PROD005,Guangzhou,10,275,265
2024-07-09,PROD004,Shenzhen,7,287,280
2024-07-10,PROD014,Shanghai,3,410,407
2024-07-11,PROD008,Guangzhou,9,1057,1048
2024-07-12,PROD009,Beijing,4,316,312
2024-07-13,PROD020,Jilin,2,928,926
2024-07-14,PROD012,Shanghai,4,676,672
2024-07-15,PROD005,Shanghai,6,654,648
2024-07-16,PROD015,Jilin,5,820,815
2024-07-17,PROD019,Jilin,4,671,667
2024-07-18,PROD001,Shenzhen,3,407,404
2024-07-19,PROD013,Jilin,5,596,591
2024-07-20,PROD009,Shanghai,4,408,404
2024-07-21,PROD002,Jilin,8,615,607
2024-07-22,PROD002,Guangzhou,1,759,758
2024-07-23,PROD007,Shenzhen,8,371,363
2024-07-24,PROD017,Jilin,2,896,894
2024-07-25,PROD001,Beijing,7,120,113
2024-07-26,PROD005,Shenzhen,9,454,445
2024-07-27,PROD001,Shanghai,3,755,752
2024-07-28,PROD012,Shanghai,9,672,663
2024-07-29,PROD006,Beijing,9,738,729
2024-07-30,PROD012,Jilin,9,687,678
2024-07-31,PROD011,Guangzhou,4,549,545
2024-08-01,PROD017,Shanghai,7,562,555
2024-08-02,PROD019,Beijing,9,437,428
2024-08-03,PROD011,Shanghai,3,364,361
2024-08-04,PROD005,Guangzhou,1,265,264
2024-08-05,PROD019,Jilin,3,667,664
2024-08-06,PROD019,Beijing,5,428,423
2024-08-07,PROD017,Guangzhou,5,196,191
2024-08-08,PROD006,Shenzhen,9,131,122
2024-08-09,PROD004,Jilin,5,172,167
2024-08-10,PROD002,Beijing,4,736,732
2024-08-11,PROD001,Shenzhen,9,404,395
2024-08-12,PROD007,Guangzhou,5,790,785
2024-08-13,PROD015,Shenzhen,7,585,578
2024-08-14,PROD012,Shenzhen,10,85,75
2024-08-15,PROD001,Shenzhen,4,395,391
2024-08-16,PROD002,Jilin,2,607,605
2024-08-17,PROD015,Shenzhen,2,578,576
2024-08-18,PROD013,Guangzhou,2,486,484
2024-08-19,PROD004,Beijing,9,488,479
2024-08-20,PROD009,Guangzhou,2,1026,1024
2024-08-21,PROD002,Shenzhen,3,888,885
2024-08-22,PROD002,Shenzhen,7,885,878
2024-08-23,PROD015,Shanghai,5,212,207
2024-08-24,PROD011,Jilin,10,213,203
2024-08-25,PROD001,Shanghai,10,752,742
2024-08-26,PROD010,Guangzhou,9,1055,1046
2024-08-27,PROD005,Guangzhou,5,264,259
2024-08-28,PROD004,Shenzhen,8,280,272
2024-08-29,PROD005,Jilin,6,575,569
2024-08-30,PROD020,Shenzhen,9,885,876
2024-08-31,PROD020,Shanghai,1,212,211
2024-09-01,PROD012,Guangzhou,8,252,244
2024-09-02,PROD016,Beijing,4,917,913
2024-09-03,PROD020,Guangzhou,6,311,305
2024-09-04,PROD008,Guangzhou,7,1048,1041
2024-09-05,PROD014,Shenzhen,4,434,430
2024-09-06,PROD018,Jilin,5,1141,1136
2024-09-07,PROD009,Guangzhou,7,1024,1017
2024-09-08,PROD013,Jilin,4,591,587
2024-09-09,PROD017,Shanghai,10,555,545
2024-09-10,PROD003,Beijing,5,1072,1067
2024-09-11,PROD008,Shenzhen,6,514,508
2024-09-12,PROD020,Shanghai,4,211,207
2024-09-13,PROD006,Guangzhou,9,999,990
2024-09-14,PROD012,Guangzhou,3,244,241
2024-09-15,PROD010,Jilin,5,202,197
2024-09-16,PROD013,Jilin,3,587,584
2024-09-17,PROD017,Shanghai,5,545,540
2024-09-18,PROD016,Shenzhen,7,163,156
2024-09-19,PROD003,Beijing,8,1067,1059
2024-09-20,PROD012,Jilin,6,678,672
2024-09-21,PROD001,Shenzhen,4,391,387
2024-09-22,PROD003,Guangzhou,6,739,733
2024-09-23,PROD014,Shenzhen,2,430,428
2024-09-24,PROD018,Beijing,8,681,673
2024-09-25,PROD019,Beijing,3,423,420
2024-09-26,PROD001,Shenzhen,9,387,378
2024-09-27,PROD019,Shenzhen,2,461,459
2024-09-28,PROD002,Shanghai,4,343,339
2024-09-29,PROD013,Jilin,3,584,581
2024-09-30,PROD002,Guangzhou,1,758,757
2024-10-01,PROD008,Shanghai,4,219,215
2024-10-02,PROD003,Guangzhou,9,733,724
2024-10-03,PROD020,Guangzhou,9,305,296
2024-10-04,PROD012,Guangzhou,1,241,240
2024-10-05,PROD015,Shanghai,8,207,199
2024-10-06,PROD010,Guangzhou,6,1046,1040
2024-10-07,PROD012,Beijing,8,816,808
2024-10-08,PROD001,Shenzhen,9,378,369
2024-10-09,PROD016,Beijing,8,913,905
2024-10-10,PROD002,Beijing,5,732,727
2024-10-11,PROD012,Shenzhen,8,75,67
2024-10-12,PROD006,Beijing,5,729,724
2024-10-13,PROD009,Shanghai,10,404,394
2024-10-14,PROD007,Guangzhou,6,785,779
2024-10-15,PROD016,Guangzhou,1,178,177
2024-10-16,PROD001,Shanghai,3,742,739
2024-10-17,PROD016,Guangzhou,6,177,171
2024-10-18,PROD019,Jilin,4,664,660
2024-10-19,PROD019,Jilin,7,660,653
2024-10-20,PROD006,Shanghai,7,172,165
2024-10-21,PROD005,Shenzhen,2,445,443
2024-10-22,PROD019,Shanghai,4,804,800
2024-10-23,PROD013,Shenzhen,2,936,934
2024-10-24,PROD016,Guangzhou,7,171,164
2024-10-25,PROD002,Jilin,10,605,595
2024-10-26,PROD017,Shenzhen,10,621,611
2024-10-27,PROD016,Beijing,5,905,900
2024-10-28,PROD002,Jilin,2,595,593
2024-10-29,PROD005,Beijing,9,452,443
2024-10-30,PROD020,Shenzhen,10,876,866
2024-10-31,PROD019,Shenzhen,5,459,454
2024-11-01,PROD009,Guangzhou,2,1017,1015
2024-11-02,PROD008,Shanghai,6,215,209
2024-11-03,PROD001,Shanghai,5,739,734
2024-11-04,PROD018,Jilin,10,1136,1126
2024-11-05,PROD015,Shenzhen,7,576,569
2024-11-06,PROD018,Shanghai,8,665,657
2024-11-07,PROD017,Shanghai,4,540,536
2024-11-08,PROD001,Beijing,5,113,108
2024-11-09,PROD008,Jilin,8,410,402
2024-11-10,PROD004,Beijing,1,479,478
2024-11-11,PROD004,Shenzhen,8,272,264
2024-11-12,PROD012,Shenzhen,9,67,58
2024-11-13,PROD011,Jilin,4,203,199
2024-11-14,PROD017,Guangzhou,3,191,188
2024-11-15,PROD020,Shanghai,5,207,202
2024-11-16,PROD007,Jilin,6,139,133
2024-11-17,PROD001,Shanghai,7,734,727
2024-11-18,PROD017,Shenzhen,9,611,602
2024-11-19,PROD005,Beijing,3,443,440
2024-11-20,PROD011,Shanghai,6,361,355
2024-11-21,PROD003,Guangzhou,3,724,721
2024-11-22,PROD010,Shenzhen,6,674,668
2024-11-23,PROD018,Shanghai,10,657,647
2024-11-24,PROD012,Jilin,6,672,666
2024-11-25,PROD007,Shanghai,4,394,390
2024-11-26,PROD002,Guangzhou,9,757,748
2024-11-27,PROD014,Guangzhou,2,139,137
2024-11-28,PROD012,Jilin,8,666,658
2024-11-29,PROD020,Jilin,2,926,924
2024-11-30,PROD006,Guangzhou,2,990,988
2024-12-01,PROD006,Beijing,8,724,716
2024-12-02,PROD011,Shenzhen,7,742,735
2024-12-03,PROD001,Beijing,2,108,106
2024-12-04,PROD019,Guangzhou,8,974,966
2024-12-05,PROD008,Jilin,9,402,393
2024-12-06,PROD010,Beijing,4,1025,1021
2024-12-07,PROD020,Guangzhou,9,296,287
2024-12-08,PROD016,Guangzhou,7,164,157
2024-12-09,PROD004,Guangzhou,2,986,984
2024-12-10,PROD006,Guangzhou,1,988,987
2024-12-11,PROD012,Beijing,2,808,806
2024-12-12,PROD004,Shenzhen,9,264,255
2024-12-13,PROD009,Beijing,4,312,308
2024-12-14,PROD003,Shenzhen,10,809,799
2024-12-15,PROD011,Jilin,8,199,191
2024-12-16,PROD011,Guangzhou,4,545,541
2024-12-17,PROD010,Beijing,4,1021,1017
2024-12-18,PROD013,Shenzhen,6,934,928
2024-12-19,PROD004,Guangzhou,9,984,975
2024-12-20,PROD003,Beijing,9,1059,1050
2024-12-21,PROD010,Jilin,8,197,189
2024-12-22,PROD010,Shanghai,9,361,352
2024-12-23,PROD012,Guangzhou,7,240,233
2024-12-24,PROD009,Guangzhou,9,1015,1006
2024-12-25,PROD011,Beijing,2,1186,1184
2024-12-26,PROD005,Jilin,1,569,568
2024-12-27,PROD009,Beijing,5,308,303
2024-12-28,PROD007,Beijing,5,75,70
2024-12-29,PROD013,Beijing,10,957,947
2024-12-30,PROD018,Shenzhen,10,929,919
2024-01-01,PROD015,Guangzhou,3,494,491
2024-01-02,PROD010,Jilin,1,189,188
2024-01-03,PROD020,Jilin,7,924,917
2024-01-04,PROD019,Shenzhen,4,454,450
2024-01-05,PROD019,Guangzhou,10,966,956
2024-01-06,PROD013,Guangzhou,5,484,479
2024-01-07,PROD008,Guangzhou,3,1041,1038
2024-01-08,PROD012,Shenzhen,9,58,49
2024-01-09,PROD004,Shanghai,2,1004,1002
2024-01-10,PROD018,Shenzhen,4,919,915
2024-01-11,PROD011,Shenzhen,5,735,730
2024-01-12,PROD011,Guangzhou,3,541,538
2024-01-13,PROD005,Jilin,7,568,561
2024-01-14,PROD014,Shenzhen,2,428,426
2024-01-15,PROD010,Jilin,8,188,180
2024-01-16,PROD013,Shanghai,6,693,687
2024-01-17,PROD009,Beijing,3,303,300
2024-01-18,PROD008,Shanghai,3,209,206
2024-01-19,PROD015,Shanghai,2,199,197
2024-01-20,PROD019,Guangzhou,2,956,954
2024-01-21,PROD015,Beijing,10,629,619
2024-01-22,PROD017,Shanghai,4,536,532
2024-01-23,PROD009,Shenzhen,3,466,463
2024-01-24,PROD003,Shanghai,7,904,897
2024-01-25,PROD005,Shenzhen,4,443,439
2024-01-26,PROD001,Jilin,2,360,358
2024-01-27,PROD015,Shanghai,1,197,196
2024-01-28,PROD020,Beijing,5,799,794
2024-01-29,PROD004,Beijing,5,478,473
2024-01-30,PROD011,Guangzhou,8,538,530
2024-01-31,PROD004,Beijing,8,473,465
2024-02-01,PROD002,Shenzhen,7,878,871
2024-02-02,PROD014,Shanghai,2,407,405
2024-02-03,PROD008,Shenzhen,7,508,501
2024-02-04,PROD001,Shanghai,10,727,717
2024-02-05,PROD006,Guangzhou,6,987,981
2024-02-06,PROD012,Shenzhen,9,49,40
2024-02-07,PROD007,Shenzhen,8,363,355
2024-02-08,PROD002,Beijing,1,727,726
2024-02-09,PROD003,Guangzhou,8,721,713
2024-02-10,PROD007,Beijing,10,70,60
2024-02-11,PROD015,Beijing,9,619,610
2024-02-12,PROD009,Shenzhen,8,463,455
2024-02-13,PROD011,Shanghai,4,355,351
2024-02-14,PROD004,Guangzhou,6,975,969
2024-02-15,PROD002,Beijing,9,726,717
2024-02-16,PROD019,Shanghai,1,800,799
2024-02-17,PROD004,Jilin,4,167,163
2024-02-18,PROD008,Guangzhou,4,1038,1034
2024-02-19,PROD011,Shanghai,9,351,342
2024-02-20,PROD010,Shanghai,2,352,350
2024-02-21,PROD003,Beijing,7,1050,1043
2024-02-22,PROD017,Guangzhou,6,188,182
2024-02-23,PROD008,Guangzhou,5,1034,1029
2024-02-24,PROD017,Shenzhen,2,602,600
2024-02-25,PROD001,Shenzhen,1,369,368
2024-02-26,PROD013,Shenzhen,6,928,922
2024-02-27,PROD013,Guangzhou,6,479,473
2024-02-28,PROD011,Guangzhou,2,530,528
2024-02-29,PROD003,Shanghai,8,897,889
2024-03-01,PROD007,Guangzhou,8,779,771
2024-03-02,PROD015,Jilin,4,815,811
2024-03-03,PROD011,Shenzhen,4,730,726
2024-03-04,PROD007,Shanghai,5,390,385
2024-03-05,PROD019,Guangzhou,1,954,953
2024-03-06,PROD015,Shenzhen,3,569,566
2024-03-07,PROD003,Jilin,3,1008,1005
2024-03-08,PROD008,Jilin,7,393,386
2024-03-09,PROD003,Guangzhou,7,713,706
2024-03-10,PROD008,Shanghai,4,206,202
2024-03-11,PROD019,Jilin,3,653,650
2024-03-12,PROD001,Jilin,5,358,353
2024-03-13,PROD011,Beijing,1,1184,1183
2024-03-14,PROD011,Guangzhou,2,528,526
2024-03-15,PROD014,Guangzhou,3,137,134
2024-03-16,PROD015,Beijing,8,610,602
2024-03-17,PROD020,Guangzhou,1,287,286
2024-03-18,PROD019,Shenzhen,7,450,443
2024-03-19,PROD005,Shanghai,9,648,639
2024-03-20,PROD005,Jilin,2,561,559
2024-03-21,PROD014,Shenzhen,1,426,425
2024-03-22,PROD003,Jilin,6,1005,999
2024-03-23,PROD003,Shanghai,7,889,882
2024-03-24,PROD007,Guangzhou,3,771,768
2024-03-25,PROD007,Jilin,1,133,132
2024-03-26,PROD002,Shanghai,5,339,334
2024-03-27,PROD003,Guangzhou,5,706,701
2024-03-28,PROD002,Jilin,2,593,591
2024-03-29,PROD015,Jilin,9,811,802
2024-03-30,PROD017,Jilin,2,894,892
2024-03-31,PROD004,Beijing,4,465,461
2024-04-01,PROD011,Jilin,4,191,187
2024-04-02,PROD012,Shenzhen,6,40,34
2024-04-03,PROD004,Guangzhou,8,969,961
2024-04-04,PROD017,Jilin,6,892,886
2024-04-05,PROD013,Beijing,6,947,941
2024-04-06,PROD009,Shanghai,5,394,389
2024-04-07,PROD018,Beijing,9,673,664
2024-04-08,PROD015,Jilin,3,802,799
2024-04-09,PROD017,Shanghai,9,532,523
2024-04-10,PROD015,Shanghai,1,196,195
2024-04-11,PROD003,Jilin,4,999,995
2024-04-12,PROD015,Shenzhen,6,566,560
2024-04-13,PROD006,Beijing,2,716,714
2024-04-14,PROD017,Guangzhou,8,182,174
2024-04-15,PROD006,Guangzhou,6,981,975
2024-04-16,PROD005,Beijing,2,440,438
2024-04-17,PROD013,Guangzhou,9,473,464
2024-04-18,PROD019,Shanghai,3,799,796
2024-04-19,PROD010,Jilin,7,180,173
2024-04-20,PROD013,Jilin,6,581,575
2024-04-21,PROD004,Jilin,1,163,162
2024-04-22,PROD015,Shenzhen,6,560,554
2024-04-23,PROD008,Beijing,3,296,293
2024-04-24,PROD010,Jilin,2,173,171
2024-04-25,PROD015,Guangzhou,2,491,489
2024-04-26,PROD019,Beijing,10,420,410
2024-04-27,PROD016,Shenzhen,4,156,152
2024-04-28,PROD020,Beijing,7,794,787
2024-04-29,PROD018,Jilin,1,1126,1125
2024-04-30,PROD018,Jilin,3,1125,1122
2024-05-01,PROD014,Guangzhou,3,134,131
2024-05-02,PROD008,Beijing,5,293,288
2024-05-03,PROD019,Beijing,2,410,408
2024-05-04,PROD010,Beijing,6,1017,1011
2024-05-05,PROD016,Shenzhen,6,152,146
2024-05-06,PROD007,Shanghai,7,385,378
2024-05-07,PROD017,Shanghai,5,523,518
2024-05-08,PROD006,Jilin,3,596,593
2024-05-09,PROD002,Guangzhou,9,748,739
2024-05-10,PROD004,Beijing,7,461,454
2024-05-11,PROD011,Guangzhou,6,526,520
2024-05-12,PROD015,Beijing,4,602,598
2024-05-13,PROD004,Beijing,7,454,447
2024-05-14,PROD017,Beijing,6,983,977
2024-05-15,PROD009,Jilin,1,221,220
2024-05-16,PROD001,Guangzhou,10,968,958
2024-05-17,PROD014,Jilin,9,454,445
2024-05-18,PROD007,Guangzhou,3,768,765
2024-05-19,PROD017,Guangzhou,9,174,165
2024-05-20,PROD004,Beijing,3,447,444
2024-05-21,PROD012,Guangzhou,9,233,224
2024-05-22,PROD006,Jilin,1,593,592
2024-05-23,PROD001,Jilin,1,353,352
2024-05-24,PROD014,Guangzhou,4,131,127
2024-05-25,PROD007,Guangzhou,6,765,759
2024-05-26,PROD011,Shenzhen,3,726,723
2024-05-27,PROD011,Jilin,6,187,181
2024-05-28,PROD011,Guangzhou,3,520,517
2024-05-29,PROD006,Shanghai,5,165,160
2024-05-30,PROD001,Guangzhou,8,958,950
2024-05-31,PROD015,Shanghai,8,195,187
2024-06-01,PROD007,Jilin,1,132,131
2024-06-02,PROD005,Shenzhen,5,439,434
2024-06-03,PROD005,Guangzhou,1,259,258
2024-06-04,PROD017,Shanghai,9,518,509
2024-06-05,PROD015,Beijing,9,598,589
2024-06-06,PROD002,Shanghai,1,334,333
2024-06-07,PROD003,Shanghai,8,882,874
2024-06-08,PROD017,Beijing,9,977,968
2024-06-09,PROD012,Jilin,8,658,650
2024-06-10,PROD004,Guangzhou,8,961,953
2024-06-11,PROD002,Beijing,9,717,708
2024-06-12,PROD002,Shenzhen,7,871,864
2024-06-13,PROD004,Shenzhen,2,255,253
2024-06-14,PROD002,Beijing,4,708,704
2024-06-15,PROD017,Guangzhou,9,165,156
2024-06-16,PROD017,Guangzhou,6,156,150
2024-06-17,PROD002,Beijing,7,704,697
2024-06-18,PROD002,Guangzhou,8,739,731
2024-06-19,PROD007,Shenzhen,4,355,351
2024-06-20,PROD005,Shenzhen,1,434,433
2024-06-21,PROD013,Beijing,8,941,933
2024-06-22,PROD019,Beijing,2,408,406
2024-06-23,PROD003,Beijing,9,1043,1034
2024-06-24,PROD008,Jilin,5,386,381
2024-06-25,PROD004,Beijing,10,444,434
2024-06-26,PROD003,Beijing,5,1034,1029
2024-06-27,PROD001,Guangzhou,3,950,947
2024-06-28,PROD016,Jilin,3,525,522
2024-06-29,PROD017,Jilin,6,886,880
2024-06-30,PROD012,Beijing,2,806,804
2024-07-01,PROD002,Beijing,2,697,695
2024-07-02,PROD015,Guangzhou,3,489,486
2024-07-03,PROD017,Shenzhen,4,600,596
2024-07-04,PROD009,Guangzhou,7,1006,999
2024-07-05,PROD020,Shenzhen,9,866,857
2024-07-06,PROD003,Jilin,3,995,992
2024-07-07,PROD009,Shenzhen,10,455,445
2024-07-08,PROD010,Guangzhou,6,1040,1034
2024-07-09,PROD003,Shenzhen,1,799,798
2024-07-10,PROD009,Beijing,6,300,294
2024-07-11,PROD002,Shenzhen,7,864,857
2024-07-12,PROD019,Jilin,3,650,647
2024-07-13,PROD010,Beijing,1,1011,1010
2024-07-14,PROD014,Jilin,9,445,436
2024-07-15,PROD005,Shenzhen,10,433,423
2024-07-16,PROD011,Shenzhen,2,723,721
2024-07-17,PROD006,Beijing,5,714,709
2024-07-18,PROD014,Jilin,1,436,435
2024-07-19,PROD006,Jilin,7,592,585
2024-07-20,PROD006,Shenzhen,6,122,116
2024-07-21,PROD006,Shanghai,1,160,159
2024-07-22,PROD020,Guangzhou,8,286,278
2024-07-23,PROD004,Shanghai,9,1002,993
2024-07-24,PROD008,Shenzhen,1,501,500
2024-07-25,PROD014,Guangzhou,2,127,125
2024-07-26,PROD015,Guangzhou,10,486,476
2024-07-27,PROD017,Guangzhou,6,150,144
2024-07-28,PROD002,Beijing,3,695,692
2024-07-29,PROD004,Shenzhen,2,253,251
2024-07-30,PROD018,Shanghai,5,647,642
2024-07-31,PROD016,Shanghai,7,941,934
2024-08-01,PROD008,Guangzhou,8,1029,1021
2024-08-02,PROD009,Shanghai,6,389,383
2024-08-03,PROD018,Guangzhou,6,806,800
2024-08-04,PROD002,Jilin,7,591,584
2024-08-05,PROD017,Shenzhen,5,596,591
2024-08-06,PROD015,Guangzhou,5,476,471
2024-08-07,PROD008,Jilin,1,381,380
2024-08-08,PROD010,Jilin,5,171,166
2024-08-09,PROD016,Shanghai,3,934,931
2024-08-10,PROD010,Jilin,3,166,163
2024-08-11,PROD002,Jilin,5,584,579
2024-08-12,PROD017,Shenzhen,5,591,586
2024-08-13,PROD003,Shenzhen,7,798,791
2024-08-14,PROD015,Guangzhou,9,471,462
2024-08-15,PROD017,Jilin,1,880,879
2024-08-16,PROD012,Jilin,1,650,649
2024-08-17,PROD001,Beijing,4,106,102
2024-08-18,PROD016,Shenzhen,3,146,143
2024-08-19,PROD007,Shanghai,8,378,370
2024-08-20,PROD010,Shenzhen,4,668,664
2024-08-21,PROD006,Beijing,1,709,708
2024-08-22,PROD020,Guangzhou,5,278,273
2024-08-23,PROD006,Shenzhen,6,116,110
2024-08-24,PROD013,Guangzhou,5,464,459
2024-08-25,PROD005,Shenzhen,9,423,414
2024-08-26,PROD019,Jilin,9,647,638
2024-08-27,PROD015,Guangzhou,10,462,452
2024-08-28,PROD003,Jilin,4,992,988
2024-08-29,PROD014,Shenzhen,5,425,420
2024-08-30,PROD009,Shenzhen,2,445,443
2024-08-31,PROD004,Guangzhou,3,953,950
2024-09-01,PROD020,Beijing,8,787,779
2024-09-02,PROD002,Jilin,3,579,576
2024-09-03,PROD016,Shenzhen,7,143,136
2024-09-04,PROD008,Guangzhou,7,1021,1014
2024-09-05,PROD017,Jilin,2,879,877
2024-09-06,PROD003,Jilin,2,988,986
2024-09-07,PROD011,Jilin,4,181,177
2024-09-08,PROD003,Jilin,2,986,984
2024-09-09,PROD005,Beijing,4,438,434
2024-09-10,PROD006,Jilin,10,585,575
2024-09-11,PROD009,Shanghai,5,383,378
2024-09-12,PROD002,Shanghai,9,333,324
2024-09-13,PROD018,Guangzhou,4,800,796
2024-09-14,PROD012,Jilin,8,649,641
2024-09-15,PROD020,Jilin,10,917,907
2024-09-16,PROD004,Shanghai,7,993,986
2024-09-17,PROD011,Shanghai,3,342,339
2024-09-18,PROD016,Jilin,2,522,520
2024-09-19,PROD012,Shenzhen,7,34,27
2024-09-20,PROD005,Shanghai,8,639,631
2024-09-21,PROD015,Shenzhen,1,554,553
2024-09-22,PROD015,Shenzhen,9,553,544
2024-09-23,PROD013,Shenzhen,6,922,916
2024-09-24,PROD020,Shanghai,5,202,197
2024-09-25,PROD010,Jilin,1,163,162
2024-09-26,PROD020,Jilin,7,907,900
2024-09-27,PROD009,Shenzhen,5,443,438
2024-09-28,PROD005,Shanghai,4,631,627
2024-09-29,PROD015,Guangzhou,9,452,443
2024-09-30,PROD016,Jilin,4,520,516
2024-10-01,PROD008,Guangzhou,10,1014,1004
2024-10-02,PROD015,Beijing,9,589,580
2024-10-03,PROD017,Jilin,1,877,876
2024-10-04,PROD016,Beijing,5,900,895
2024-10-05,PROD006,Jilin,3,575,572
2024-10-06,PROD020,Guangzhou,6,273,267
2024-10-07,PROD012,Shanghai,8,663,655
2024-10-08,PROD007,Jilin,6,131,125
2024-10-09,PROD001,Shenzhen,7,368,361
2024-10-10,PROD014,Beijing,7,339,332
2024-10-11,PROD001,Guangzhou,5,947,942
2024-10-12,PROD007,Guangzhou,8,759,751
2024-10-13,PROD011,Shenzhen,1,721,720
2024-10-14,PROD011,Shanghai,9,339,330
2024-10-15,PROD011,Shenzhen,7,720,713
2024-10-16,PROD020,Beijing,3,779,776
2024-10-17,PROD019,Shanghai,10,796,786
2024-10-18,PROD015,Jilin,3,799,796
2024-10-19,PROD011,Jilin,9,177,168
2024-10-20,PROD019,Beijing,6,406,400
2024-10-21,PROD015,Shenzhen,2,544,542
2024-10-22,PROD014,Shanghai,10,405,395
2024-10-23,PROD003,Jilin,7,984,977
2024-10-24,PROD020,Shenzhen,8,857,849
2024-10-25,PROD003,Shanghai,9,874,865
2024-10-26,PROD005,Beijing,9,434,425
2024-10-27,PROD020,Shanghai,8,197,189
2024-10-28,PROD006,Jilin,7,572,565
2024-10-29,PROD018,Guangzhou,5,796,791
2024-10-30,PROD010,Shenzhen,8,664,656
2024-10-31,PROD009,Shanghai,7,378,371
2024-11-01,PROD010,Shenzhen,5,656,651
2024-11-02,PROD009,Guangzhou,1,999,998
2024-11-03,PROD013,Shenzhen,10,916,906
2024-11-04,PROD012,Guangzhou,9,224,215
2024-11-05,PROD015,Shanghai,10,187,177
2024-11-06,PROD002,Jilin,1,576,575
2024-11-07,PROD013,Shanghai,1,687,686
2024-11-08,PROD019,Shenzhen,2,443,441
2024-11-09,PROD019,Shanghai,6,786,780
2024-11-10,PROD014,Guangzhou,7,125,118
2024-11-11,PROD013,Shenzhen,4,906,902
2024-11-12,PROD014,Shanghai,10,395,385
2024-11-13,PROD019,Beijing,3,400,397
2024-11-14,PROD011,Jilin,4,168,164
2024-11-15,PROD007,Jilin,5,125,120
2024-11-16,PROD006,Jilin,9,565,556
2024-11-17,PROD009,Guangzhou,7,998,991
2024-11-18,PROD010,Jilin,2,162,160
2024-11-19,PROD016,Guangzhou,10,157,147
2024-11-20,PROD009,Guangzhou,4,991,987
2024-11-21,PROD002,Jilin,3,575,572
2024-11-22,PROD017,Jilin,6,876,870
2024-11-23,PROD015,Beijing,9,580,571
2024-11-24,PROD007,Shenzhen,9,351,342
2024-11-25,PROD015,Shanghai,7,177,170
2024-11-26,PROD011,Jilin,5,164,159
2024-11-27,PROD008,Jilin,4,380,376
2024-11-28,PROD010,Guangzhou,9,1034,1025
2024-11-29,PROD001,Shanghai,10,717,707
2024-11-30,PROD008,Beijing,10,288,278
2024-12-01,PROD011,Shanghai,3,330,327
2024-12-02,PROD018,Shenzhen,7,915,908
2024-12-03,PROD008,Shanghai,5,202,197
2024-12-04,PROD005,Shenzhen,7,414,407
2024-12-05,PROD020,Beijing,7,776,769
2024-12-06,PROD007,Guangzhou,8,751,743
2024-12-07,PROD002,Shenzhen,7,857,850
2024-12-08,PROD020,Shanghai,2,189,187
2024-12-09,PROD011,Shenzhen,8,713,705
2024-12-10,PROD015,Guangzhou,10,443,433
2024-12-11,PROD018,Beijing,6,664,658
2024-12-12,PROD010,Beijing,9,1010,1001
2024-12-13,PROD014,Beijing,3,332,329
2024-12-14,PROD005,Guangzhou,9,258,249
2024-12-15,PROD018,Guangzhou,2,791,789
2024-12-16,PROD008,Guangzhou,7,1004,997
2024-12-17,PROD009,Guangzhou,4,987,983
2024-12-18,PROD005,Shanghai,4,627,623
2024-12-19,PROD009,Jilin,6,220,214
2024-12-20,PROD020,Shenzhen,7,849,842
2024-12-21,PROD003,Shenzhen,8,791,783
2024-12-22,PROD014,Jilin,10,435,425
2024-12-23,PROD017,Shanghai,9,509,500
2024-12-24,PROD013,Jilin,6,575,569
2024-12-25,PROD016,Beijing,3,895,892
2024-12-26,PROD015,Shanghai,1,170,169
2024-12-27,PROD005,Beijing,6,425,419
2024-12-28,PROD011,Jilin,8,159,151
2024-12-29,PROD005,Jilin,7,559,552
2024-12-30,PROD012,Guangzhou,6,215,209
2024-01-01,PROD003,Beijing,7,1029,1022
2024-01-02,PROD002,Shenzhen,5,850,845
2024-01-03,PROD019,Shenzhen,7,441,434
2024-01-04,PROD004,Jilin,7,162,155
2024-01-05,PROD018,Guangzhou,9,789,780
2024-01-06,PROD001,Shenzhen,4,361,357
2024-01-07,PROD012,Beijing,6,804,798
2024-01-08,PROD019,Jilin,5,638,633
2024-01-09,PROD017,Shenzhen,4,586,582
2024-01-10,PROD005,Jilin,5,552,547
2024-01-11,PROD016,Jilin,3,516,513
2024-01-12,PROD005,Shenzhen,7,407,400
2024-01-13,PROD001,Beijing,3,102,99
2024-01-14,PROD006,Shenzhen,2,110,108
2024-01-15,PROD013,Jilin,10,569,559
2024-01-16,PROD010,Shenzhen,3,651,648
2024-01-17,PROD005,Beijing,1,419,418
2024-01-18,PROD003,Jilin,4,977,973
2024-01-19,PROD006,Shanghai,6,159,153
2024-01-20,PROD003,Shanghai,4,865,861
2024-01-21,PROD006,Shanghai,2,153,151
2024-01-22,PROD018,Shanghai,8,642,634
2024-01-23,PROD015,Shanghai,9,169,160
2024-01-24,PROD017,Guangzhou,8,144,136
2024-01-25,PROD011,Shenzhen,10,705,695
2024-01-26,PROD007,Beijing,8,60,52
2024-01-27,PROD020,Jilin,8,900,892
2024-01-28,PROD020,Shenzhen,3,842,839
2024-01-29,PROD002,Shenzhen,1,845,844
2024-01-30,PROD018,Jilin,6,1122,1116
2024-01-31,PROD017,Shanghai,6,500,494
2024-02-01,PROD018,Guangzhou,3,780,777
2024-02-02,PROD017,Jilin,3,870,867
2024-02-03,PROD011,Beijing,9,1183,1174
2024-02-04,PROD003,Shenzhen,4,783,779
2024-02-05,PROD008,Jilin,1,376,375
2024-02-06,PROD008,Jilin,6,375,369
2024-02-07,PROD018,Shanghai,6,634,628
2024-02-08,PROD019,Shanghai,9,780,771
2024-02-09,PROD005,Guangzhou,3,249,246
2024-02-10,PROD005,Shenzhen,10,400,390
2024-02-11,PROD016,Beijing,9,892,883
2024-02-12,PROD017,Beijing,6,968,962
2024-02-13,PROD017,Shenzhen,1,582,581
2024-02-14,PROD016,Shanghai,9,931,922
2024-02-15,PROD013,Jilin,9,559,550
2024-02-16,PROD005,Guangzhou,9,246,237
2024-02-17,PROD005,Shanghai,2,623,621
2024-02-18,PROD007,Jilin,3,120,117
2024-02-19,PROD008,Shenzhen,5,500,495
2024-02-20,PROD011,Beijing,9,1174,1165
2024-02-21,PROD020,Beijing,5,769,764
2024-02-22,PROD012,Shenzhen,3,27,24
2024-02-23,PROD017,Jilin,10,867,857
2024-02-24,PROD017,Guangzhou,2,136,134
2024-02-25,PROD009,Shanghai,6,371,365
2024-02-26,PROD002,Beijing,4,692,688
2024-02-27,PROD014,Beijing,6,329,323
2024-02-28,PROD006,Shenzhen,6,108,102
2024-02-29,PROD003,Shanghai,9,861,852
2024-03-01,PROD005,Guangzhou,5,237,232
2024-03-02,PROD009,Shanghai,9,365,356
2024-03-03,PROD017,Beijing,7,962,955
2024-03-04,PROD012,Beijing,3,798,795
2024-03-05,PROD003,Shanghai,7,852,845
2024-03-06,PROD010,Beijing,9,1001,992
2024-03-07,PROD005,Shenzhen,10,390,380
2024-03-08,PROD001,Guangzhou,8,942,934
2024-03-09,PROD020,Guangzhou,1,267,266
2024-03-10,PROD017,Guangzhou,10,134,124
2024-03-11,PROD002,Guangzhou,7,731,724
2024-03-12,PROD001,Beijing,1,99,98
2024-03-13,PROD013,Beijing,7,933,926
2024-03-14,PROD016,Shenzhen,8,136,128
2024-03-15,PROD009,Shenzhen,9,438,429
2024-03-16,PROD017,Shanghai,10,494,484
2024-03-17,PROD020,Shanghai,8,187,179
2024-03-18,PROD003,Shenzhen,5,779,774
2024-03-19,PROD010,Shanghai,1,350,349
2024-03-20,PROD003,Jilin,2,973,971
2024-03-21,PROD003,Guangzhou,8,701,693
2024-03-22,PROD019,Jilin,7,633,626
2024-03-23,PROD007,Jilin,5,117,112
2024-03-24,PROD020,Shenzhen,8,839,831
2024-03-25,PROD016,Shenzhen,4,128,124
2024-03-26,PROD020,Shenzhen,9,831,822
2024-03-27,PROD001,Shenzhen,1,357,356
2024-03-28,PROD014,Jilin,9,425,416
2024-03-29,PROD016,Shanghai,10,922,912
2024-03-30,PROD011,Jilin,6,151,145
2024-03-31,PROD018,Guangzhou,4,777,773
2024-04-01,PROD012,Jilin,4,641,637
2024-04-02,PROD015,Beijing,6,571,565
2024-04-03,PROD018,Shenzhen,7,908,901
2024-04-04,PROD018,Jilin,8,1116,1108
2024-04-05,PROD007,Beijing,3,52,49
2024-04-06,PROD011,Beijing,7,1165,1158
2024-04-07,PROD013,Shanghai,10,686,676
2024-04-08,PROD007,Beijing,8,49,41
2024-04-09,PROD006,Beijing,8,708,700
2024-04-10,PROD017,Shenzhen,8,581,573
2024-04-11,PROD018,Jilin,8,1108,1100
2024-04-12,PROD002,Shenzhen,6,844,838
2024-04-13,PROD005,Shanghai,2,621,619
2024-04-14,PROD011,Guangzhou,7,517,510
2024-04-15,PROD009,Shenzhen,2,429,427
2024-04-16,PROD015,Shenzhen,9,542,533
2024-04-17,PROD003,Shenzhen,2,774,772
2024-04-18,PROD005,Jilin,9,547,538
2024-04-19,PROD001,Shanghai,10,707,697
2024-04-20,PROD001,Jilin,7,352,345
2024-04-21,PROD014,Shenzhen,6,420,414
2024-04-22,PROD017,Guangzhou,7,124,117
2024-04-23,PROD012,Shenzhen,10,24,14
2024-04-24,PROD003,Jilin,1,971,970
2024-04-25,PROD008,Shenzhen,6,495,489
2024-04-26,PROD004,Shenzhen,10,251,241
2024-04-27,PROD012,Jilin,8,637,629
2024-04-28,PROD016,Guangzhou,9,147,138
2024-04-29,PROD011,Shenzhen,4,695,691
2024-04-30,PROD004,Shenzhen,5,241,236
2024-05-01,PROD009,Guangzhou,9,983,974
2024-05-02,PROD004,Shenzhen,1,236,235
2024-05-03,PROD017,Guangzhou,9,117,108
2024-05-04,PROD011,Guangzhou,8,510,502
2024-05-05,PROD007,Beijing,2,41,39
2024-05-06,PROD019,Jilin,6,626,620
2024-05-07,PROD007,Beijing,2,39,37
2024-05-08,PROD014,Guangzhou,10,118,108
2024-05-09,PROD009,Jilin,8,214,206
2024-05-10,PROD019,Shanghai,1,771,770
2024-05-11,PROD012,Jilin,4,629,625
2024-05-12,PROD004,Jilin,1,155,154
2024-05-13,PROD016,Shanghai,4,912,908
2024-05-14,PROD015,Guangzhou,8,433,425
2024-05-15,PROD018,Beijing,4,658,654
2024-05-16,PROD005,Jilin,9,538,529
2024-05-17,PROD015,Beijing,5,565,560
2024-05-18,PROD013,Guangzhou,8,459,451
2024-05-19,PROD010,Guangzhou,9,1025,1016
2024-05-20,PROD016,Shenzhen,9,124,115
2024-05-21,PROD018,Jilin,6,1100,1094
2024-05-22,PROD003,Guangzhou,9,693,684
2024-05-23,PROD006,Shenzhen,3,102,99
2024-05-24,PROD004,Beijing,5,434,429
2024-05-25,PROD003,Beijing,7,1022,1015
2024-05-26,PROD008,Shenzhen,8,489,481
2024-05-27,PROD004,Shenzhen,1,235,234
2024-05-28,PROD015,Shenzhen,7,533,526
2024-05-29,PROD003,Guangzhou,1,684,683
2024-05-30,PROD002,Beijing,4,688,684
2024-05-31,PROD017,Shanghai,2,484,482
2024-06-01,PROD011,Shenzhen,7,691,684
2024-06-02,PROD006,Beijing,9,700,691
2024-06-03,PROD001,Guangzhou,7,934,927
2024-06-04,PROD020,Jilin,1,892,891
2024-06-05,PROD008,Jilin,5,369,364
2024-06-06,PROD006,Guangzhou,3,975,972
2024-06-07,PROD017,Shenzhen,3,573,570
2024-06-08,PROD019,Shanghai,2,770,768
2024-06-09,PROD010,Guangzhou,5,1016,1011
2024-06-10,PROD009,Shanghai,5,356,351
2024-06-11,PROD016,Beijing,3,883,880
2024-06-12,PROD017,Guangzhou,7,108,101
2024-06-13,PROD018,Guangzhou,1,773,772
2024-06-14,PROD005,Jilin,6,529,523
2024-06-15,PROD001,Shanghai,8,697,689
2024-06-16,PROD015,Jilin,7,796,789
2024-06-17,PROD020,Shenzhen,5,822,817
2024-06-18,PROD020,Jilin,10,891,881
2024-06-19,PROD010,Guangzhou,9,1011,1002
2024-06-20,PROD015,Guangzhou,9,425,416
2024-06-21,PROD009,Shenzhen,7,427,420
2024-06-22,PROD007,Shanghai,8,370,362
2024-06-23,PROD003,Beijing,5,1015,1010
2024-06-24,PROD015,Shanghai,6,160,154
2024-06-25,PROD019,Shanghai,2,768,766
2024-06-26,PROD002,Shenzhen,9,838,829
2024-06-27,PROD009,Guangzhou,7,974,967
2024-06-28,PROD001,Guangzhou,1,927,926
2024-06-29,PROD019,Shanghai,8,766,758
2024-06-30,PROD008,Jilin,8,364,356
2024-07-01,PROD010,Shenzhen,5,648,643
2024-07-02,PROD005,Guangzhou,10,232,222
2024-07-03,PROD020,Beijing,7,764,757
2024-07-04,PROD006,Shenzhen,2,99,97
2024-07-05,PROD019,Guangzhou,7,953,946
2024-07-06,PROD002,Jilin,8,572,564
2024-07-07,PROD013,Beijing,6,926,920
2024-07-08,PROD020,Shanghai,10,179,169
2024-07-09,PROD003,Beijing,4,1010,1006
2024-07-10,PROD019,Guangzhou,9,946,937
2024-07-11,PROD016,Shanghai,6,908,902
2024-07-12,PROD017,Shenzhen,5,570,565
2024-07-13,PROD002,Beijing,4,684,680
2024-07-14,PROD007,Shenzhen,7,342,335
2024-07-15,PROD006,Beijing,9,691,682
2024-07-16,PROD009,Jilin,4,206,202
2024-07-17,PROD006,Beijing,8,682,674
2024-07-18,PROD002,Jilin,9,564,555
2024-07-19,PROD015,Jilin,10,789,779
2024-07-20,PROD009,Shenzhen,8,420,412
2024-07-21,PROD007,Jilin,10,112,102
2024-07-22,PROD011,Guangzhou,4,502,498
2024-07-23,PROD012,Beijing,4,795,791
2024-07-24,PROD005,Shenzhen,4,380,376
2024-07-25,PROD020,Guangzhou,1,266,265
2024-07-26,PROD018,Beijing,10,654,644
2024-07-27,PROD018,Beijing,8,644,636
2024-07-28,PROD007,Shanghai,4,362,358
2024-07-29,PROD009,Guangzhou,5,967,962
2024-07-30,PROD011,Shenzhen,9,684,675
2024-07-31,PROD002,Shenzhen,6,829,823
2024-08-01,PROD020,Guangzhou,8,265,257
2024-08-02,PROD008,Shenzhen,9,481,472
2024-08-03,PROD019,Shanghai,1,758,757
2024-08-04,PROD020,Beijing,9,757,748
2024-08-05,PROD007,Shenzhen,1,335,334
2024-08-06,PROD006,Beijing,5,674,669
2024-08-07,PROD008,Jilin,4,356,352
2024-08-08,PROD015,Shanghai,9,154,145
2024-08-09,PROD019,Guangzhou,8,937,929
2024-08-10,PROD003,Beijing,10,1006,996
2024-08-11,PROD017,Guangzhou,4,101,97
2024-08-12,PROD001,Shanghai,8,689,681
2024-08-13,PROD002,Guangzhou,8,724,716
2024-08-14,PROD014,Shanghai,9,385,376
2024-08-15,PROD008,Guangzhou,9,997,988
2024-08-16,PROD001,Jilin,9,345,336
2024-08-17,PROD011,Shenzhen,10,675,665
2024-08-18,PROD001,Shenzhen,5,356,351
2024-08-19,PROD018,Shanghai,4,628,624
2024-08-20,PROD006,Beijing,6,669,663
2024-08-21,PROD019,Jilin,4,620,616
2024-08-22,PROD011,Guangzhou,9,498,489
2024-08-23,PROD001,Shenzhen,4,351,347
2024-08-24,PROD013,Guangzhou,5,451,446
2024-08-25,PROD005,Shenzhen,10,376,366
2024-08-26,PROD009,Beijing,2,294,292
2024-08-27,PROD001,Guangzhou,8,926,918
2024-08-28,PROD010,Shanghai,10,349,339
2024-08-29,PROD019,Beijing,3,397,394
2024-08-30,PROD004,Shanghai,10,986,976
2024-08-31,PROD004,Shanghai,2,976,974
2024-09-01,PROD012,Jilin,9,625,616
2024-09-02,PROD010,Shenzhen,6,643,637
2024-09-03,PROD008,Shanghai,3,197,194
2024-09-04,PROD014,Shenzhen,10,414,404
2024-09-05,PROD020,Jilin,10,881,871
2024-09-06,PROD008,Beijing,2,278,276
2024-09-07,PROD002,Shenzhen,1,823,822
2024-09-08,PROD019,Guangzhou,10,929,919
2024-09-09,PROD019,Beijing,10,394,384
2024-09-10,PROD001,Guangzhou,6,918,912
2024-09-11,PROD019,Beijing,10,384,374
2024-09-12,PROD005,Jilin,4,523,519
2024-09-13,PROD009,Beijing,6,292,286
2024-09-14,PROD008,Guangzhou,8,988,980
2024-09-15,PROD001,Guangzhou,4,912,908
2024-09-16,PROD015,Shenzhen,6,526,520
2024-09-17,PROD002,Shanghai,9,324,315
2024-09-18,PROD010,Beijing,3,992,989
2024-09-19,PROD008,Jilin,3,352,349
2024-09-20,PROD010,Jilin,10,160,150
2024-09-21,PROD009,Guangzhou,2,962,960
2024-09-22,PROD011,Shenzhen,5,665,660
2024-09-23,PROD013,Jilin,2,550,548
2024-09-24,PROD016,Shanghai,7,902,895
2024-09-25,PROD017,Jilin,3,857,854
2024-09-26,PROD013,Guangzhou,2,446,444
2024-09-27,PROD005,Shenzhen,3,366,363
2024-09-28,PROD014,Beijing,7,323,316
2024-09-29,PROD019,Shanghai,8,757,749
2024-09-30,PROD006,Jilin,1,556,555
2024-10-01,PROD001,Shenzhen,1,347,346
2024-10-02,PROD019,Guangzhou,2,919,917
2024-10-03,PROD012,Jilin,3,616,613
2024-10-04,PROD014,Guangzhou,9,108,99
2024-10-05,PROD020,Shenzhen,2,817,815
2024-10-06,PROD008,Shenzhen,9,472,463
2024-10-07,PROD014,Guangzhou,4,99,95
2024-10-08,PROD014,Guangzhou,6,95,89
2024-10-09,PROD004,Beijing,8,429,421
2024-10-10,PROD020,Beijing,9,748,739
2024-10-11,PROD003,Jilin,3,970,967
2024-10-12,PROD019,Jilin,10,616,606
2024-10-13,PROD020,Jilin,9,871,862
2024-10-14,PROD020,Jilin,2,862,860
2024-10-15,PROD013,Shenzhen,8,902,894
2024-10-16,PROD012,Beijing,10,791,781
2024-10-17,PROD005,Jilin,5,519,514
2024-10-18,PROD002,Guangzhou,7,716,709
2024-10-19,PROD006,Jilin,5,555,550
2024-10-20,PROD010,Guangzhou,7,1002,995
2024-10-21,PROD008,Shanghai,7,194,187
2024-10-22,PROD017,Beijing,10,955,945
2024-10-23,PROD002,Shenzhen,1,822,821
2024-10-24,PROD003,Shenzhen,7,772,765
2024-10-25,PROD014,Guangzhou,7,89,82
2024-10-26,PROD018,Shenzhen,5,901,896
2024-10-27,PROD003,Beijing,2,996,994
2024-10-28,PROD017,Guangzhou,5,97,92
2024-10-29,PROD010,Shanghai,7,339,332
2024-10-30,PROD007,Beijing,5,37,32
2024-10-31,PROD014,Shanghai,3,376,373
2024-11-01,PROD004,Beijing,9,421,412
2024-11-02,PROD006,Jilin,1,550,549
2024-11-03,PROD017,Guangzhou,6,92,86
2024-11-04,PROD004,Shenzhen,4,234,230
2024-11-05,PROD013,Jilin,4,548,544
2024-11-06,PROD012,Shanghai,1,655,654
2024-11-07,PROD006,Guangzhou,8,972,964
2024-11-08,PROD016,Shanghai,4,895,891
2024-11-09,PROD019,Shenzhen,10,434,424
2024-11-10,PROD002,Beijing,1,680,679
2024-11-11,PROD012,Beijing,8,781,773
2024-11-12,PROD011,Guangzhou,2,489,487
2024-11-13,PROD017,Guangzhou,1,86,85
2024-11-14,PROD009,Beijing,6,286,280
2024-11-15,PROD019,Beijing,2,374,372
2024-11-16,PROD007,Guangzhou,7,743,736
2024-11-17,PROD019,Beijing,8,372,364
2024-11-18,PROD013,Shenzhen,9,894,885
2024-11-19,PROD004,Shanghai,6,974,968
2024-11-20,PROD016,Beijing,1,880,879
2024-11-21,PROD017,Guangzhou,5,85,80
2024-11-22,PROD012,Shenzhen,1,14,13
2024-11-23,PROD003,Shanghai,6,845,839
2024-11-24,PROD020,Jilin,2,860,858
2024-11-25,PROD008,Guangzhou,3,980,977
2024-11-26,PROD004,Guangzhou,7,950,943
2024-11-27,PROD010,Guangzhou,10,995,985
2024-11-28,PROD016,Guangzhou,7,138,131
2024-11-29,PROD016,Beijing,8,879,871
2024-11-30,PROD009,Guangzhou,1,960,959
2024-12-01,PROD001,Shanghai,4,681,677
2024-12-02,PROD017,Guangzhou,7,80,73
2024-12-03,PROD020,Guangzhou,7,257,250
2024-12-04,PROD010,Shenzhen,8,637,629
2024-12-05,PROD002,Shenzhen,5,821,816
2024-12-06,PROD015,Beijing,8,560,552
2024-12-07,PROD009,Shenzhen,5,412,407
2024-12-08,PROD007,Shenzhen,9,334,325
2024-12-09,PROD001,Shenzhen,1,346,345
2024-12-10,PROD018,Jilin,2,1094,1092
2024-12-11,PROD003,Beijing,5,994,989
2024-12-12,PROD020,Jilin,2,858,856
2024-12-13,PROD009,Jilin,6,202,196
2024-12-14,PROD003,Jilin,3,967,964
2024-12-15,PROD019,Shanghai,7,749,742
2024-12-16,PROD020,Beijing,1,739,738
2024-12-17,PROD014,Guangzhou,3,82,79
2024-12-18,PROD008,Guangzhou,8,977,969
2024-12-19,PROD005,Shanghai,8,619,611
2024-12-20,PROD007,Beijing,2,32,30
2024-12-21,PROD003,Shanghai,6,839,833
2024-12-22,PROD011,Jilin,10,145,135
2024-12-23,PROD006,Jilin,3,549,546
2024-12-24,PROD018,Shenzhen,4,896,892
2024-12-25,PROD002,Shanghai,5,315,310
2024-12-26,PROD005,Jilin,3,514,511
2024-12-27,PROD011,Shenzhen,5,660,655
2024-12-28,PROD016,Shanghai,8,891,883
2024-12-29,PROD007,Beijing,1,30,29
2024-12-30,PROD015,Shenzhen,2,520,518
2024-01-01,PROD017,Jilin,5,854,849
2024-01-02,PROD001,Shanghai,2,677,675
2024-01-03,PROD010,Jilin,5,150,145
2024-01-04,PROD017,Beijing,8,945,937
2024-01-05,PROD008,Shenzhen,2,463,461
2024-01-06,PROD018,Shenzhen,1,892,891
2024-01-07,PROD011,Jilin,6,135,129
2024-01-08,PROD020,Beijing,7,738,731
2024-01-09,PROD015,Beijing,6,552,546
2024-01-10,PROD003,Shenzhen,1,765,764
2024-01-11,PROD020,Beijing,4,731,727
2024-01-12,PROD017,Shanghai,2,482,480
2024-01-13,PROD018,Guangzhou,4,772,768
2024-01-14,PROD003,Jilin,4,964,960
2024-01-15,PROD018,Guangzhou,6,768,762
2024-01-16,PROD003,Guangzhou,6,683,677
2024-01-17,PROD018,Jilin,9,1092,1083
2024-01-18,PROD002,Shanghai,6,310,304
2024-01-19,PROD003,Jilin,4,960,956
2024-01-20,PROD006,Guangzhou,5,964,959
2024-01-21,PROD012,Beijing,5,773,768
2024-01-22,PROD020,Shenzhen,1,815,814
2024-01-23,PROD020,Shanghai,3,169,166
2024-01-24,PROD015,Beijing,10,546,536
2024-01-25,PROD020,Shanghai,1,166,165
2024-01-26,PROD006,Beijing,9,663,654
2024-01-27,PROD001,Guangzhou,8,908,900
2024-01-28,PROD020,Shenzhen,9,814,805
2024-01-29,PROD012,Beijing,2,768,766
2024-01-30,PROD010,Beijing,10,989,979
2024-01-31,PROD011,Shenzhen,8,655,647
2024-02-01,PROD002,Shenzhen,4,816,812
2024-02-02,PROD006,Shanghai,1,151,150
2024-02-03,PROD014,Beijing,2,316,314
2024-02-04,PROD012,Beijing,2,766,764
2024-02-05,PROD019,Guangzhou,1,917,916
2024-02-06,PROD011,Shanghai,7,327,320
2024-02-07,PROD009,Guangzhou,1,959,958
2024-02-08,PROD019,Shanghai,7,742,735
2024-02-09,PROD001,Shanghai,8,675,667
2024-02-10,PROD005,Shenzhen,5,363,358
2024-02-11,PROD007,Beijing,3,29,26
2024-02-12,PROD013,Guangzhou,8,444,436
2024-02-13,PROD018,Guangzhou,10,762,752
2024-02-14,PROD015,Guangzhou,2,416,414
2024-02-15,PROD007,Beijing,9,26,17
2024-02-16,PROD011,Shenzhen,3,647,644
2024-02-17,PROD016,Jilin,9,513,504
2024-02-18,PROD019,Jilin,3,606,603
2024-02-19,PROD003,Shanghai,5,833,828
2024-02-20,PROD014,Shenzhen,9,404,395
2024-02-21,PROD001,Beijing,6,98,92
2024-02-22,PROD004,Beijing,7,412,405
2024-02-23,PROD004,Shanghai,9,968,959
2024-02-24,PROD006,Shanghai,5,150,145
2024-02-25,PROD019,Shenzhen,6,424,418
2024-02-26,PROD007,Jilin,7,102,95
2024-02-27,PROD020,Beijing,3,727,724
2024-02-28,PROD016,Shenzhen,2,115,113
2024-02-29,PROD019,Jilin,5,603,598
2024-03-01,PROD001,Guangzhou,2,900,898
2024-03-02,PROD002,Shenzhen,6,812,806
2024-03-03,PROD004,Guangzhou,9,943,934
2024-03-04,PROD004,Shenzhen,6,230,224
2024-03-05,PROD009,Beijing,4,280,276
2024-03-06,PROD011,Jilin,3,129,126
2024-03-07,PROD003,Shenzhen,6,764,758
2024-03-08,PROD012,Beijing,10,764,754
2024-03-09,PROD003,Jilin,10,956,946
2024-03-10,PROD019,Jilin,10,598,588
2024-03-11,PROD002,Jilin,1,555,554
2024-03-12,PROD019,Beijing,7,364,357
2024-03-13,PROD009,Guangzhou,3,958,955
2024-03-14,PROD001,Beijing,6,92,86
2024-03-15,PROD008,Shenzhen,10,461,451
2024-03-16,PROD005,Beijing,7,418,411
2024-03-17,PROD019,Shenzhen,2,418,416
2024-03-18,PROD019,Guangzhou,9,916,907
2024-03-19,PROD011,Shanghai,7,320,313
2024-03-20,PROD015,Jilin,6,779,773
2024-03-21,PROD019,Jilin,4,588,584
2024-03-22,PROD012,Beijing,9,754,745
2024-03-23,PROD016,Jilin,3,504,501
2024-03-24,PROD010,Jilin,4,145,141
2024-03-25,PROD007,Jilin,7,95,88
2024-03-26,PROD005,Beijing,2,411,409
2024-03-27,PROD018,Shenzhen,9,891,882
2024-03-28,PROD015,Shenzhen,1,518,517
2024-03-29,PROD013,Guangzhou,1,436,435
2024-03-30,PROD005,Shanghai,1,611,610
2024-03-31,PROD020,Shenzhen,10,805,795
2024-04-01,PROD015,Beijing,1,536,535
2024-04-02,PROD004,Beijing,7,405,398
2024-04-03,PROD011,Guangzhou,8,487,479
2024-04-04,PROD005,Shanghai,3,610,607
2024-04-05,PROD006,Shenzhen,4,97,93
2024-04-06,PROD010,Guangzhou,2,985,983
2024-04-07,PROD007,Shenzhen,2,325,323
2024-04-08,PROD015,Jilin,1,773,772
2024-04-09,PROD012,Shanghai,10,654,644
2024-04-10,PROD012,Guangzhou,8,209,201
2024-04-11,PROD016,Jilin,1,501,500
2024-04-12,PROD010,Jilin,7,141,134
2024-04-13,PROD017,Beijing,5,937,932
2024-04-14,PROD020,Guangzhou,3,250,247
2024-04-15,PROD017,Shenzhen,10,565,555
2024-04-16,PROD010,Beijing,2,979,977
2024-04-17,PROD006,Shenzhen,10,93,83
2024-04-18,PROD011,Beijing,9,1158,1149
2024-04-19,PROD018,Beijing,9,636,627
2024-04-20,PROD010,Beijing,5,977,972
2024-04-21,PROD012,Jilin,2,613,611
2024-04-22,PROD004,Guangzhou,4,934,930
2024-04-23,PROD017,Guangzhou,7,73,66
2024-04-24,PROD016,Jilin,5,500,495
2024-04-25,PROD012,Beijing,7,745,738
2024-04-26,PROD005,Shenzhen,5,358,353
2024-04-27,PROD010,Shenzhen,3,629,626
2024-04-28,PROD006,Guangzhou,8,959,951
2024-04-29,PROD007,Jilin,4,88,84
2024-04-30,PROD004,Shenzhen,2,224,222
2024-05-01,PROD007,Shanghai,9,358,349
2024-05-02,PROD016,Beijing,2,871,869
2024-05-03,PROD003,Jilin,3,946,943
2024-05-04,PROD008,Beijing,9,276,267
2024-05-05,PROD007,Shanghai,4,349,345
2024-05-06,PROD020,Shenzhen,10,795,785
2024-05-07,PROD014,Guangzhou,8,79,71
2024-05-08,PROD017,Beijing,3,932,929
2024-05-09,PROD019,Beijing,7,357,350
2024-05-10,PROD005,Shanghai,5,607,602
2024-05-11,PROD012,Shanghai,5,644,639
2024-05-12,PROD010,Beijing,8,972,964
2024-05-13,PROD010,Jilin,5,134,129
2024-05-14,PROD001,Jilin,6,336,330
2024-05-15,PROD015,Jilin,1,772,771
2024-05-16,PROD001,Beijing,6,86,80
2024-05-17,PROD005,Shenzhen,3,353,350
2024-05-18,PROD010,Jilin,5,129,124
2024-05-19,PROD020,Guangzhou,10,247,237
2024-05-20,PROD015,Shenzhen,6,517,511
2024-05-21,PROD020,Jilin,3,856,853
2024-05-22,PROD001,Guangzhou,5,898,893
2024-05-23,PROD005,Guangzhou,10,222,212
2024-05-24,PROD001,Beijing,8,80,72
2024-05-25,PROD006,Shanghai,8,145,137
2024-05-26,PROD012,Jilin,9,611,602
2024-05-27,PROD016,Jilin,4,495,491
2024-05-28,PROD020,Shanghai,9,165,156
2024-05-29,PROD009,Shanghai,9,351,342
2024-05-30,PROD015,Beijing,9,535,526
2024-05-31,PROD009,Shanghai,6,342,336
2024-06-01,PROD009,Shanghai,6,336,330
2024-06-02,PROD011,Beijing,4,1149,1145
2024-06-03,PROD016,Shenzhen,9,113,104
2024-06-04,PROD010,Beijing,6,964,958
2024-06-05,PROD008,Beijing,4,267,263
2024-06-06,PROD010,Guangzhou,1,983,982
2024-06-07,PROD007,Shenzhen,3,323,320
2024-06-08,PROD013,Beijing,6,920,914
2024-06-09,PROD002,Shanghai,6,304,298
2024-06-10,PROD014,Jilin,4,416,412
2024-06-11,PROD019,Shenzhen,5,416,411
2024-06-12,PROD016,Shenzhen,5,104,99
2024-06-13,PROD008,Jilin,2,349,347
2024-06-14,PROD015,Shanghai,7,145,138
2024-06-15,PROD018,Shenzhen,10,882,872
2024-06-16,PROD002,Guangzhou,3,709,706
2024-06-17,PROD006,Guangzhou,5,951,946
2024-06-18,PROD003,Beijing,7,989,982
2024-06-19,PROD008,Beijing,5,263,258
2024-06-20,PROD016,Shanghai,8,883,875
2024-06-21,PROD002,Guangzhou,2,706,704
2024-06-22,PROD007,Guangzhou,7,736,729
2024-06-23,PROD014,Beijing,1,314,313
2024-06-24,PROD004,Jilin,6,154,148
2024-06-25,PROD019,Beijing,8,350,342
2024-06-26,PROD007,Guangzhou,1,729,728
2024-06-27,PROD018,Beijing,2,627,625
2024-06-28,PROD014,Shanghai,8,373,365
2024-06-29,PROD009,Shanghai,2,330,328
2024-06-30,PROD016,Shenzhen,4,99,95
2024-07-01,PROD013,Jilin,7,544,537
2024-07-02,PROD005,Beijing,3,409,406
2024-07-03,PROD001,Beijing,4,72,68
2024-07-04,PROD008,Guangzhou,3,969,966
2024-07-05,PROD005,Shenzhen,9,350,341
2024-07-06,PROD015,Guangzhou,4,414,410
2024-07-07,PROD018,Jilin,6,1083,1077
2024-07-08,PROD008,Beijing,8,258,250
2024-07-09,PROD015,Shenzhen,9,511,502
2024-07-10,PROD005,Shenzhen,5,341,336
2024-07-11,PROD005,Jilin,3,511,508
2024-07-12,PROD018,Shanghai,8,624,616
2024-07-13,PROD015,Shenzhen,4,502,498
2024-07-14,PROD008,Shenzhen,3,451,448
2024-07-15,PROD012,Shenzhen,4,13,9
2024-07-16,PROD007,Beijing,6,17,11
2024-07-17,PROD014,Shenzhen,7,395,388
2024-07-18,PROD019,Shanghai,3,735,732
2024-07-19,PROD015,Shenzhen,6,498,492
2024-07-20,PROD008,Jilin,1,347,346
2024-07-21,PROD011,Beijing,5,1145,1140
2024-07-22,PROD010,Shenzhen,2,626,624
2024-07-23,PROD009,Beijing,7,276,269
2024-07-24,PROD018,Jilin,3,1077,1074
2024-07-25,PROD007,Shanghai,7,345,338
2024-07-26,PROD006,Jilin,1,546,545
2024-07-27,PROD001,Jilin,3,330,327
2024-07-28,PROD020,Shenzhen,3,785,782
2024-07-29,PROD016,Shanghai,8,875,867
2024-07-30,PROD018,Shanghai,6,616,610
2024-07-31,PROD007,Jilin,3,84,81
2024-08-01,PROD008,Beijing,5,250,245
2024-08-02,PROD001,Jilin,10,327,317
2024-08-03,PROD006,Shenzhen,3,83,80
2024-08-04,PROD015,Jilin,8,771,763
2024-08-05,PROD009,Shenzhen,9,407,398
2024-08-06,PROD010,Shenzhen,3,624,621
2024-08-07,PROD009,Shanghai,9,328,319
2024-08-08,PROD012,Guangzhou,1,201,200
2024-08-09,PROD018,Beijing,2,625,623
2024-08-10,PROD001,Jilin,10,317,307
2024-08-11,PROD013,Shanghai,3,676,673
2024-08-12,PROD002,Jilin,4,554,550
2024-08-13,PROD003,Shenzhen,5,758,753
2024-08-14,PROD020,Jilin,10,853,843
2024-08-15,PROD020,Jilin,5,843,838
2024-08-16,PROD008,Jilin,4,346,342
2024-08-17,PROD006,Shanghai,6,137,131
2024-08-18,PROD012,Beijing,6,738,732
2024-08-19,PROD018,Shenzhen,2,872,870
2024-08-20,PROD013,Jilin,8,537,529
2024-08-21,PROD007,Beijing,5,11,6
2024-08-22,PROD016,Beijing,7,869,862
2024-08-23,PROD009,Beijing,5,269,264
2024-08-24,PROD018,Beijing,10,623,613
2024-08-25,PROD005,Beijing,1,406,405
2024-08-26,PROD019,Shanghai,2,732,730
2024-08-27,PROD012,Shanghai,8,639,631
2024-08-28,PROD003,Shenzhen,6,753,747
2024-08-29,PROD010,Guangzhou,9,982,973
2024-08-30,PROD002,Guangzhou,8,704,696
2024-08-31,PROD001,Shanghai,8,667,659
2024-09-01,PROD002,Shenzhen,1,806,805
2024-09-02,PROD011,Guangzhou,10,479,469
2024-09-03,PROD006,Jilin,7,545,538
2024-09-04,PROD017,Guangzhou,4,66,62
2024-09-05,PROD005,Beijing,3,405,402
2024-09-06,PROD015,Beijing,9,526,517
2024-09-07,PROD019,Guangzhou,4,907,903
2024-09-08,PROD009,Jilin,5,196,191
2024-09-09,PROD020,Shenzhen,3,782,779
2024-09-10,PROD018,Shenzhen,9,870,861
2024-09-11,PROD016,Shanghai,3,867,864
2024-09-12,PROD008,Jilin,4,342,338
2024-09-13,PROD019,Beijing,10,342,332
2024-09-14,PROD020,Shanghai,7,156,149
2024-09-15,PROD013,Shanghai,1,673,672
2024-09-16,PROD018,Shanghai,6,610,604
2024-09-17,PROD014,Shanghai,3,365,362
2024-09-18,PROD014,Jilin,8,412,404
2024-09-19,PROD009,Shanghai,10,319,309
2024-09-20,PROD018,Beijing,1,613,612
2024-09-21,PROD018,Guangzhou,6,752,746
2024-09-22,PROD018,Beijing,10,612,602
2024-09-23,PROD011,Guangzhou,6,469,463
2024-09-24,PROD018,Jilin,9,1074,1065
2024-09-25,PROD008,Shanghai,9,187,178
2024-09-26,PROD005,Beijing,7,402,395
2024-09-27,PROD002,Guangzhou,10,696,686
2024-09-28,PROD010,Guangzhou,6,973,967
2024-09-29,PROD020,Shanghai,3,149,146
2024-09-30,PROD004,Shenzhen,4,222,218
2024-10-01,PROD002,Jilin,3,550,547
2024-10-02,PROD001,Beijing,8,68,60
2024-10-03,PROD019,Beijing,3,332,329
2024-10-04,PROD006,Guangzhou,7,946,939
2024-10-05,PROD010,Shenzhen,5,621,616
2024-10-06,PROD001,Shanghai,10,659,649
2024-10-07,PROD020,Jilin,2,838,836
2024-10-08,PROD014,Jilin,10,404,394
2024-10-09,PROD016,Guangzhou,1,131,130
2024-10-10,PROD002,Shenzhen,3,805,802
2024-10-11,PROD003,Beijing,5,982,977
2024-10-12,PROD005,Shanghai,8,602,594
2024-10-13,PROD009,Jilin,9,191,182
2024-10-14,PROD017,Guangzhou,1,62,61
2024-10-15,PROD001,Jilin,7,307,300
2024-10-16,PROD017,Shenzhen,8,555,547
2024-10-17,PROD020,Beijing,10,724,714
2024-10-18,PROD008,Guangzhou,10,966,956
2024-10-19,PROD006,Shenzhen,8,80,72
2024-10-20,PROD007,Jilin,10,81,71
2024-10-21,PROD009,Jilin,8,182,174
2024-10-22,PROD004,Shanghai,3,959,956
2024-10-23,PROD008,Beijing,9,245,236
2024-10-24,PROD016,Shenzhen,3,95,92
2024-10-25,PROD012,Beijing,9,732,723
2024-10-26,PROD007,Guangzhou,1,728,727
2024-10-27,PROD001,Shanghai,6,649,643
2024-10-28,PROD014,Shenzhen,4,388,384
2024-10-29,PROD010,Jilin,6,124,118
2024-10-30,PROD010,Shenzhen,2,616,614
2024-10-31,PROD020,Guangzhou,9,237,228
2024-11-01,PROD004,Shanghai,4,956,952
2024-11-02,PROD010,Jilin,5,118,113
2024-11-03,PROD020,Guangzhou,8,228,220
2024-11-04,PROD015,Shenzhen,5,492,487
2024-11-05,PROD018,Beijing,6,602,596
2024-11-06,PROD006,Jilin,2,538,536
2024-11-07,PROD011,Jilin,8,126,118
2024-11-08,PROD013,Beijing,8,914,906
2024-11-09,PROD007,Shanghai,6,338,332
2024-11-10,PROD014,Guangzhou,10,71,61
2024-11-11,PROD017,Guangzhou,4,61,57
2024-11-12,PROD011,Shenzhen,1,644,643
2024-11-13,PROD020,Shanghai,7,146,139
2024-11-14,PROD007,Beijing,6,6,0
2024-11-15,PROD009,Shenzhen,7,398,391
2024-11-16,PROD020,Beijing,2,714,712
2024-11-17,PROD017,Jilin,7,849,842
2024-11-18,PROD010,Beijing,1,958,957
2024-11-19,PROD004,Shenzhen,10,218,208
2024-11-20,PROD010,Guangzhou,7,967,960
2024-11-21,PROD012,Shenzhen,2,9,7
2024-11-22,PROD001,Beijing,6,60,54
2024-11-23,PROD007,Beijing,3,0,0
2024-11-24,PROD001,Shenzhen,2,345,343
2024-11-25,PROD010,Jilin,5,113,108
2024-11-26,PROD006,Beijing,4,654,650
2024-11-27,PROD010,Shenzhen,3,614,611
2024-11-28,PROD019,Shenzhen,8,411,403
2024-11-29,PROD015,Beijing,8,517,509
2024-11-30,PROD004,Jilin,6,148,142
2024-12-01,PROD012,Beijing,9,723,714
2024-12-02,PROD013,Shanghai,9,672,663
2024-12-03,PROD009,Shanghai,8,309,301
2024-12-04,PROD010,Guangzhou,7,960,953
2024-12-05,PROD016,Shenzhen,7,92,85
2024-12-06,PROD002,Jilin,6,547,541
2024-12-07,PROD018,Beijing,4,596,592
2024-12-08,PROD017,Shenzhen,8,547,539
2024-12-09,PROD002,Guangzhou,4,686,682
2024-12-10,PROD006,Shanghai,10,131,121
2024-12-11,PROD019,Guangzhou,8,903,895
2024-12-12,PROD020,Guangzhou,1,220,219
2024-12-13,PROD013,Guangzhou,8,435,427
2024-12-14,PROD011,Shenzhen,2,643,641
2024-12-15,PROD014,Jilin,9,394,385
2024-12-16,PROD003,Jilin,9,943,934
2024-12-17,PROD005,Jilin,10,508,498
2024-12-18,PROD002,Shenzhen,5,802,797
2024-12-19,PROD007,Shenzhen,4,320,316
2024-12-20,PROD003,Jilin,6,934,928
2024-12-21,PROD013,Beijing,1,906,905
2024-12-22,PROD009,Shanghai,6,301,295
2024-12-23,PROD013,Shenzhen,3,885,882
2024-12-24,PROD020,Guangzhou,10,219,209
2024-12-25,PROD015,Guangzhou,9,410,401
2024-12-26,PROD018,Shenzhen,8,861,853
2024-12-27,PROD009,Guangzhou,5,955,950
2024-12-28,PROD008,Jilin,1,338,337
2024-12-29,PROD017,Jilin,7,842,835
2024-12-30,PROD003,Guangzhou,6,677,671
2024-01-01,PROD005,Guangzhou,1,212,211
2024-01-02,PROD008,Shenzhen,3,448,445
2024-01-03,PROD020,Shanghai,3,139,136
2024-01-04,PROD003,Beijing,8,977,969
2024-01-05,PROD002,Shenzhen,6,797,791
2024-01-06,PROD013,Jilin,6,529,523
2024-01-07,PROD009,Beijing,3,264,261
2024-01-08,PROD005,Beijing,5,395,390
2024-01-09,PROD016,Shenzhen,7,85,78
2024-01-10,PROD009,Jilin,8,174,166
2024-01-11,PROD019,Shanghai,1,730,729
2024-01-12,PROD007,Jilin,2,71,69
2024-01-13,PROD007,Jilin,4,69,65
2024-01-14,PROD013,Shenzhen,10,882,872
2024-01-15,PROD018,Shenzhen,7,853,846
2024-01-16,PROD015,Beijing,9,509,500
2024-01-17,PROD005,Jilin,10,498,488
2024-01-18,PROD018,Beijing,5,592,587
2024-01-19,PROD014,Jilin,1,385,384
2024-01-20,PROD019,Beijing,10,329,319
2024-01-21,PROD006,Beijing,3,650,647
2024-01-22,PROD005,Jilin,8,488,480
2024-01-23,PROD007,Beijing,2,0,0
2024-01-24,PROD014,Guangzhou,3,61,58
2024-01-25,PROD016,Beijing,4,862,858
2024-01-26,PROD018,Beijing,8,587,579
2024-01-27,PROD013,Beijing,7,905,898
2024-01-28,PROD018,Guangzhou,6,746,740
2024-01-29,PROD018,Shenzhen,1,846,845
2024-01-30,PROD002,Shenzhen,2,791,789
2024-01-31,PROD015,Guangzhou,4,401,397
2024-02-01,PROD004,Beijing,5,398,393
2024-02-02,PROD007,Shenzhen,5,316,311
2024-02-03,PROD019,Shenzhen,8,403,395
2024-02-04,PROD009,Jilin,9,166,157
2024-02-05,PROD018,Beijing,2,579,577
2024-02-06,PROD003,Shanghai,9,828,819
2024-02-07,PROD016,Shanghai,3,864,861
2024-02-08,PROD005,Guangzhou,2,211,209
2024-02-09,PROD018,Jilin,5,1065,1060
2024-02-10,PROD005,Shanghai,4,594,590
2024-02-11,PROD017,Jilin,7,835,828
2024-02-12,PROD016,Shenzhen,2,78,76
2024-02-13,PROD004,Jilin,2,142,140
2024-02-14,PROD011,Beijing,5,1140,1135
2024-02-15,PROD010,Shenzhen,9,611,602
2024-02-16,PROD018,Beijing,10,577,567
2024-02-17,PROD004,Beijing,6,393,387
2024-02-18,PROD001,Guangzhou,4,893,889
2024-02-19,PROD008,Beijing,10,236,226
2024-02-20,PROD011,Beijing,10,1135,1125
2024-02-21,PROD008,Guangzhou,9,956,947
2024-02-22,PROD019,Jilin,2,584,582
2024-02-23,PROD005,Guangzhou,8,209,201
2024-02-24,PROD002,Guangzhou,3,682,679
2024-02-25,PROD004,Shanghai,2,952,950
2024-02-26,PROD001,Beijing,4,54,50
2024-02-27,PROD011,Shenzhen,7,641,634
2024-02-28,PROD006,Jilin,2,536,534
2024-02-29,PROD011,Beijing,5,1125,1120
2024-03-01,PROD008,Shanghai,1,178,177
2024-03-02,PROD017,Beijing,5,929,924
2024-03-03,PROD005,Guangzhou,4,201,197
2024-03-04,PROD017,Shanghai,8,480,472
2024-03-05,PROD007,Guangzhou,3,727,724
2024-03-06,PROD010,Beijing,6,957,951
2024-03-07,PROD006,Beijing,4,647,643
2024-03-08,PROD008,Beijing,5,226,221
2024-03-09,PROD015,Shanghai,3,138,135
2024-03-10,PROD008,Beijing,9,221,212
2024-03-11,PROD007,Guangzhou,6,724,718
2024-03-12,PROD020,Shenzhen,5,779,774
2024-03-13,PROD004,Shanghai,4,950,946
2024-03-14,PROD006,Shenzhen,1,72,71
2024-03-15,PROD014,Shanghai,7,362,355
2024-03-16,PROD018,Guangzhou,8,740,732
2024-03-17,PROD018,Shanghai,10,604,594
2024-03-18,PROD008,Shenzhen,10,445,435
2024-03-19,PROD004,Shanghai,1,946,945
2024-03-20,PROD015,Jilin,5,763,758
2024-03-21,PROD016,Beijing,6,858,852
2024-03-22,PROD018,Shanghai,9,594,585
2024-03-23,PROD019,Beijing,1,319,318
2024-03-24,PROD013,Shanghai,2,663,661
2024-03-25,PROD013,Jilin,6,523,517
2024-03-26,PROD017,Guangzhou,1,57,56
2024-03-27,PROD004,Shenzhen,2,208,206
2024-03-28,PROD007,Beijing,6,0,0
2024-03-29,PROD014,Jilin,8,384,376
2024-03-30,PROD013,Jilin,9,517,508
2024-03-31,PROD003,Beijing,10,969,959
2024-04-01,PROD016,Shenzhen,3,76,73
2024-04-02,PROD006,Jilin,10,534,524
2024-04-03,PROD010,Jilin,6,108,102
2024-04-04,PROD017,Beijing,10,924,914
2024-04-05,PROD020,Beijing,3,712,709
2024-04-06,PROD002,Shenzhen,9,789,780
2024-04-07,PROD003,Shenzhen,6,747,741
2024-04-08,PROD019,Shanghai,2,729,727
2024-04-09,PROD015,Jilin,7,758,751
2024-04-10,PROD013,Jilin,6,508,502
2024-04-11,PROD011,Guangzhou,1,463,462
2024-04-12,PROD003,Guangzhou,8,671,663
2024-04-13,PROD011,Shenzhen,4,634,630
2024-04-14,PROD009,Guangzhou,6,950,944
2024-04-15,PROD012,Guangzhou,1,200,199
2024-04-16,PROD020,Shanghai,10,136,126
2024-04-17,PROD017,Guangzhou,2,56,54
2024-04-18,PROD019,Guangzhou,2,895,893
2024-04-19,PROD015,Shenzhen,6,487,481
2024-04-20,PROD010,Jilin,1,102,101
2024-04-21,PROD012,Shenzhen,2,7,5
2024-04-22,PROD009,Jilin,1,157,156
2024-04-23,PROD018,Guangzhou,2,732,730
2024-04-24,PROD005,Shenzhen,8,336,328
2024-04-25,PROD017,Shanghai,8,472,464
2024-04-26,PROD015,Jilin,6,751,745
2024-04-27,PROD020,Shenzhen,10,774,764
2024-04-28,PROD016,Jilin,3,491,488
2024-04-29,PROD005,Beijing,2,390,388
2024-04-30,PROD006,Beijing,8,643,635
2024-05-01,PROD005,Jilin,5,480,475
2024-05-02,PROD014,Jilin,4,376,372
2024-05-03,PROD016,Shanghai,6,861,855
2024-05-04,PROD016,Guangzhou,3,130,127
2024-05-05,PROD001,Beijing,2,50,48
2024-05-06,PROD009,Guangzhou,5,944,939
2024-05-07,PROD013,Guangzhou,10,427,417
2024-05-08,PROD015,Shenzhen,3,481,478
2024-05-09,PROD009,Guangzhou,5,939,934
2024-05-10,PROD015,Beijing,10,500,490
2024-05-11,PROD006,Shanghai,6,121,115
2024-05-12,PROD003,Shenzhen,7,741,734
2024-05-13,PROD020,Guangzhou,4,209,205
2024-05-14,PROD011,Jilin,9,118,109
2024-05-15,PROD001,Shenzhen,9,343,334
2024-05-16,PROD010,Guangzhou,2,953,951
2024-05-17,PROD015,Shanghai,1,135,134
2024-05-18,PROD002,Beijing,3,679,676
2024-05-19,PROD008,Guangzhou,10,947,937
2024-05-20,PROD017,Shenzhen,4,539,535
2024-05-21,PROD009,Beijing,2,261,259
2024-05-22,PROD004,Shenzhen,4,206,202
2024-05-23,PROD012,Jilin,9,602,593
2024-05-24,PROD014,Shanghai,10,355,345
2024-05-25,PROD001,Jilin,8,300,292
2024-05-26,PROD010,Beijing,7,951,944
2024-05-27,PROD001,Shenzhen,5,334,329
2024-05-28,PROD015,Beijing,10,490,480
2024-05-29,PROD016,Shanghai,8,855,847
2024-05-30,PROD016,Jilin,5,488,483
2024-05-31,PROD012,Guangzhou,4,199,195
2024-06-01,PROD019,Beijing,4,318,314
2024-06-02,PROD003,Beijing,1,959,958
2024-06-03,PROD016,Shenzhen,9,73,64
2024-06-04,PROD011,Beijing,1,1120,1119
2024-06-05,PROD003,Shanghai,1,819,818
2024-06-06,PROD020,Shenzhen,9,764,755
2024-06-07,PROD008,Guangzhou,4,937,933
2024-06-08,PROD007,Guangzhou,9,718,709
2024-06-09,PROD003,Shenzhen,3,734,731
2024-06-10,PROD020,Guangzhou,4,205,201
2024-06-11,PROD013,Beijing,9,898,889
2024-06-12,PROD008,Beijing,5,212,207
2024-06-13,PROD005,Beijing,5,388,383
2024-06-14,PROD004,Jilin,3,140,137
2024-06-15,PROD016,Shanghai,5,847,842
2024-06-16,PROD012,Shanghai,10,631,621
2024-06-17,PROD017,Jilin,1,828,827
2024-06-18,PROD007,Jilin,9,65,56
2024-06-19,PROD015,Beijing,6,480,474
2024-06-20,PROD006,Shenzhen,8,71,63
2024-06-21,PROD005,Shanghai,4,590,586
2024-06-22,PROD013,Shenzhen,2,872,870
2024-06-23,PROD019,Jilin,8,582,574
2024-06-24,PROD006,Jilin,10,524,514
2024-06-25,PROD009,Jilin,8,156,148
2024-06-26,PROD006,Jilin,2,514,512
2024-06-27,PROD006,Shenzhen,2,63,61
2024-06-28,PROD011,Jilin,6,109,103
2024-06-29,PROD019,Jilin,9,574,565
2024-06-30,PROD010,Guangzhou,9,951,942
2024-07-01,PROD017,Guangzhou,5,54,49
2024-07-02,PROD012,Shenzhen,3,5,2
2024-07-03,PROD009,Guangzhou,2,934,932
2024-07-04,PROD010,Beijing,7,944,937
2024-07-05,PROD008,Guangzhou,5,933,928
2024-07-06,PROD001,Shenzhen,6,329,323
2024-07-07,PROD003,Beijing,5,958,953
2024-07-08,PROD002,Shenzhen,5,780,775
2024-07-09,PROD018,Shanghai,4,585,581
2024-07-10,PROD017,Beijing,1,914,913
2024-07-11,PROD009,Jilin,3,148,145
2024-07-12,PROD003,Jilin,5,928,923
2024-07-13,PROD008,Shenzhen,6,435,429
2024-07-14,PROD002,Guangzhou,5,679,674
2024-07-15,PROD003,Jilin,5,923,918
2024-07-16,PROD004,Shenzhen,2,202,200
2024-07-17,PROD012,Shenzhen,8,2,0
2024-07-18,PROD009,Shenzhen,5,391,386
2024-07-19,PROD014,Jilin,4,372,368
2024-07-20,PROD014,Beijing,1,313,312
2024-07-21,PROD005,Beijing,7,383,376
2024-07-22,PROD004,Guangzhou,5,930,925
2024-07-23,PROD002,Shenzhen,1,775,774
2024-07-24,PROD001,Beijing,10,48,38
2024-07-25,PROD008,Beijing,2,207,205
2024-07-26,PROD012,Guangzhou,2,195,193
2024-07-27,PROD004,Beijing,8,387,379
2024-07-28,PROD004,Guangzhou,4,925,921
2024-07-29,PROD001,Shenzhen,10,323,313
2024-07-30,PROD005,Jilin,7,475,468
2024-07-31,PROD008,Shanghai,2,177,175
2024-08-01,PROD018,Shanghai,4,581,577
2024-08-02,PROD018,Guangzhou,5,730,725
2024-08-03,PROD002,Shenzhen,8,774,766
2024-08-04,PROD009,Shanghai,6,295,289
2024-08-05,PROD020,Guangzhou,3,201,198
2024-08-06,PROD012,Beijing,2,714,712
2024-08-07,PROD016,Beijing,6,852,846
2024-08-08,PROD002,Jilin,4,541,537
2024-08-09,PROD014,Jilin,9,368,359
2024-08-10,PROD014,Guangzhou,6,58,52
2024-08-11,PROD020,Jilin,8,836,828
2024-08-12,PROD008,Shanghai,10,175,165
2024-08-13,PROD018,Shanghai,8,577,569
2024-08-14,PROD003,Guangzhou,4,663,659
2024-08-15,PROD005,Shenzhen,8,328,320
2024-08-16,PROD011,Shanghai,5,313,308
2024-08-17,PROD010,Shenzhen,4,602,598
2024-08-18,PROD016,Jilin,6,483,477
2024-08-19,PROD006,Jilin,1,512,511
2024-08-20,PROD013,Shanghai,1,661,660
2024-08-21,PROD004,Shanghai,10,945,935
2024-08-22,PROD013,Shenzhen,6,870,864
2024-08-23,PROD016,Beijing,5,846,841
2024-08-24,PROD007,Shenzhen,9,311,302
2024-08-25,PROD011,Jilin,9,103,94
2024-08-26,PROD012,Beijing,3,712,709
2024-08-27,PROD012,Beijing,1,709,708
2024-08-28,PROD019,Jilin,7,565,558
2024-08-29,PROD001,Jilin,9,292,283
2024-08-30,PROD009,Shanghai,8,289,281
2024-08-31,PROD013,Jilin,3,502,499
2024-09-01,PROD017,Shanghai,6,464,458
2024-09-02,PROD014,Beijing,5,312,307
2024-09-03,PROD006,Shenzhen,1,61,60
2024-09-04,PROD020,Shenzhen,1,755,754
2024-09-05,PROD016,Shenzhen,8,64,56
2024-09-06,PROD009,Jilin,1,145,144
2024-09-07,PROD004,Guangzhou,6,921,915
2024-09-08,PROD014,Beijing,10,307,297
2024-09-09,PROD004,Shenzhen,2,200,198
2024-09-10,PROD004,Shenzhen,10,198,188
2024-09-11,PROD013,Shenzhen,2,864,862
2024-09-12,PROD014,Beijing,1,297,296
2024-09-13,PROD006,Shanghai,6,115,109
2024-09-14,PROD017,Jilin,5,827,822
2024-09-15,PROD020,Jilin,8,828,820
2024-09-16,PROD002,Jilin,5,537,532
2024-09-17,PROD003,Shenzhen,10,731,721
2024-09-18,PROD013,Shenzhen,10,862,852
2024-09-19,PROD014,Shenzhen,3,384,381
2024-09-20,PROD011,Jilin,4,94,90
2024-09-21,PROD002,Shenzhen,6,766,760
2024-09-22,PROD018,Guangzhou,7,725,718
2024-09-23,PROD006,Jilin,6,511,505
2024-09-24,PROD015,Beijing,5,474,469
2024-09-25,PROD010,Shanghai,1,332,331
2024-09-26,PROD013,Shenzhen,4,852,848
2024-09-27,PROD016,Guangzhou,6,127,121
2024-09-28,PROD010,Shanghai,9,331,322
2024-09-29,PROD009,Jilin,3,144,141
2024-09-30,PROD019,Jilin,1,558,557
2024-10-01,PROD012,Guangzhou,10,193,183
2024-10-02,PROD006,Guangzhou,9,939,930
2024-10-03,PROD010,Shanghai,1,322,321
2024-10-04,PROD009,Beijing,6,259,253
2024-10-05,PROD014,Jilin,10,359,349
2024-10-06,PROD019,Guangzhou,6,893,887
2024-10-07,PROD006,Shanghai,5,109,104
2024-10-08,PROD011,Guangzhou,7,462,455
2024-10-09,PROD005,Beijing,2,376,374
2024-10-10,PROD014,Jilin,8,349,341
2024-10-11,PROD006,Guangzhou,8,930,922
2024-10-12,PROD010,Jilin,2,101,99
2024-10-13,PROD003,Beijing,3,953,950
2024-10-14,PROD006,Guangzhou,4,922,918
2024-10-15,PROD005,Shenzhen,2,320,318
2024-10-16,PROD015,Shanghai,9,134,125
2024-10-17,PROD009,Beijing,9,253,244
2024-10-18,PROD010,Shenzhen,6,598,592
2024-10-19,PROD019,Guangzhou,9,887,878
2024-10-20,PROD014,Beijing,8,296,288
2024-10-21,PROD005,Jilin,9,468,459
2024-10-22,PROD009,Shanghai,9,281,272
2024-10-23,PROD014,Jilin,10,341,331
2024-10-24,PROD007,Guangzhou,1,709,708
2024-10-25,PROD003,Shanghai,10,818,808
2024-10-26,PROD019,Shanghai,10,727,717
2024-10-27,PROD014,Shanghai,2,345,343
2024-10-28,PROD003,Shenzhen,7,721,714
2024-10-29,PROD010,Shanghai,1,321,320
2024-10-30,PROD004,Guangzhou,5,915,910
2024-10-31,PROD005,Beijing,4,374,370
2024-11-01,PROD009,Shenzhen,4,386,382
2024-11-02,PROD014,Jilin,6,331,325
2024-11-03,PROD015,Shanghai,4,125,121
2024-11-04,PROD012,Shenzhen,10,0,0
2024-11-05,PROD012,Shanghai,3,621,618
2024-11-06,PROD018,Jilin,10,1060,1050
2024-11-07,PROD018,Beijing,4,567,563
2024-11-08,PROD008,Jilin,3,337,334
2024-11-09,PROD011,Jilin,8,90,82
2024-11-10,PROD003,Shanghai,5,808,803
2024-11-11,PROD004,Guangzhou,3,910,907
2024-11-12,PROD001,Guangzhou,6,889,883
2024-11-13,PROD006,Shenzhen,2,60,58
2024-11-14,PROD009,Shanghai,10,272,262
2024-11-15,PROD010,Shanghai,8,320,312
2024-11-16,PROD014,Beijing,5,288,283
2024-11-17,PROD007,Shanghai,7,332,325
2024-11-18,PROD009,Beijing,1,244,243
2024-11-19,PROD004,Shenzhen,3,188,185
2024-11-20,PROD012,Shenzhen,7,0,0
2024-11-21,PROD020,Guangzhou,5,198,193
2024-11-22,PROD007,Beijing,7,0,0
2024-11-23,PROD019,Shenzhen,7,395,388
2024-11-24,PROD010,Beijing,4,937,933
2024-11-25,PROD006,Jilin,7,505,498
2024-11-26,PROD001,Guangzhou,7,883,876
2024-11-27,PROD010,Shanghai,8,312,304
2024-11-28,PROD018,Shenzhen,10,845,835
2024-11-29,PROD018,Jilin,1,1050,1049
2024-11-30,PROD009,Beijing,3,243,240
2024-12-01,PROD013,Jilin,3,499,496
2024-12-02,PROD002,Jilin,9,532,523
2024-12-03,PROD014,Beijing,10,283,273
2024-12-04,PROD018,Shenzhen,4,835,831
2024-12-05,PROD012,Beijing,10,708,698
2024-12-06,PROD019,Jilin,6,557,551
2024-12-07,PROD009,Shanghai,3,262,259
2024-12-08,PROD010,Guangzhou,10,942,932
2024-12-09,PROD009,Jilin,3,141,138
2024-12-10,PROD019,Shanghai,9,717,708
2024-12-11,PROD019,Shenzhen,1,388,387
2024-12-12,PROD001,Beijing,1,38,37
2024-12-13,PROD020,Jilin,4,820,816
2024-12-14,PROD001,Beijing,6,37,31
2024-12-15,PROD018,Guangzhou,3,718,715
2024-12-16,PROD017,Shanghai,8,458,450
2024-12-17,PROD004,Beijing,6,379,373
2024-12-18,PROD018,Shenzhen,1,831,830
2024-12-19,PROD017,Guangzhou,7,49,42
2024-12-20,PROD001,Shenzhen,7,313,306
2024-12-21,PROD009,Jilin,10,138,128
2024-12-22,PROD002,Shanghai,4,298,294
2024-12-23,PROD004,Jilin,6,137,131
2024-12-24,PROD010,Beijing,1,933,932
2024-12-25,PROD003,Beijing,9,950,941
2024-12-26,PROD014,Guangzhou,3,52,49
2024-12-27,PROD005,Shanghai,1,586,585
2024-12-28,PROD013,Guangzhou,1,417,416
2024-12-29,PROD010,Guangzhou,2,932,930
2024-12-30,PROD013,Guangzhou,7,416,409
2024-01-01,PROD009,Beijing,4,240,236
2024-01-02,PROD020,Guangzhou,1,193,192
2024-01-03,PROD017,Shenzhen,6,535,529
2024-01-04,PROD008,Beijing,9,205,196
2024-01-05,PROD019,Jilin,5,551,546
2024-01-06,PROD006,Shanghai,10,104,94
2024-01-07,PROD005,Beijing,10,370,360
2024-01-08,PROD004,Shenzhen,5,185,180
2024-01-09,PROD007,Guangzhou,9,708,699
2024-01-10,PROD007,Guangzhou,3,699,696
2024-01-11,PROD016,Guangzhou,8,121,113
2024-01-12,PROD016,Shanghai,6,842,836
2024-01-13,PROD011,Shanghai,5,308,303
2024-01-14,PROD013,Jilin,2,496,494
2024-01-15,PROD007,Jilin,6,56,50
2024-01-16,PROD019,Beijing,2,314,312
2024-01-17,PROD005,Guangzhou,9,197,188
2024-01-18,PROD006,Shanghai,10,94,84
2024-01-19,PROD019,Shanghai,9,708,699
2024-01-20,PROD019,Shenzhen,7,387,380
2024-01-21,PROD016,Shenzhen,2,56,54
2024-01-22,PROD003,Shanghai,5,803,798
2024-01-23,PROD020,Shanghai,1,126,125
2024-01-24,PROD009,Beijing,8,236,228
2024-01-25,PROD010,Guangzhou,4,930,926
2024-01-26,PROD015,Jilin,7,745,738
2024-01-27,PROD010,Jilin,8,99,91
2024-01-28,PROD006,Guangzhou,10,918,908
2024-01-29,PROD007,Shanghai,3,325,322
2024-01-30,PROD020,Shanghai,3,125,122
2024-01-31,PROD001,Shanghai,9,643,634
2024-02-01,PROD007,Guangzhou,7,696,689
2024-02-02,PROD006,Beijing,1,635,634
2024-02-03,PROD010,Guangzhou,2,926,924
2024-02-04,PROD018,Jilin,9,1049,1040
2024-02-05,PROD009,Jilin,3,128,125
2024-02-06,PROD018,Jilin,4,1040,1036
2024-02-07,PROD012,Shanghai,2,618,616
2024-02-08,PROD004,Shanghai,10,935,925
2024-02-09,PROD009,Shenzhen,8,382,374
2024-02-10,PROD007,Shenzhen,4,302,298
2024-02-11,PROD004,Guangzhou,6,907,901
2024-02-12,PROD008,Shanghai,3,165,162
2024-02-13,PROD016,Beijing,1,841,840
2024-02-14,PROD015,Beijing,9,469,460
2024-02-15,PROD003,Guangzhou,9,659,650
2024-02-16,PROD006,Shanghai,8,84,76
2024-02-17,PROD012,Shenzhen,9,0,0
2024-02-18,PROD004,Jilin,7,131,124
2024-02-19,PROD013,Shanghai,10,660,650
2024-02-20,PROD014,Shanghai,6,343,337
2024-02-21,PROD018,Jilin,6,1036,1030
2024-02-22,PROD017,Shenzhen,4,529,525
2024-02-23,PROD014,Shanghai,4,337,333
2024-02-24,PROD019,Beijing,9,312,303
2024-02-25,PROD008,Guangzhou,8,928,920
2024-02-26,PROD003,Jilin,9,918,909
2024-02-27,PROD019,Jilin,7,546,539
2024-02-28,PROD004,Beijing,9,373,364
2024-02-29,PROD006,Jilin,10,498,488
2024-03-01,PROD006,Shenzhen,4,58,54
2024-03-02,PROD013,Shanghai,5,650,645
2024-03-03,PROD002,Shanghai,1,294,293
2024-03-04,PROD016,Beijing,4,840,836
2024-03-05,PROD020,Shenzhen,3,754,751
2024-03-06,PROD003,Shenzhen,5,714,709
2024-03-07,PROD011,Shanghai,6,303,297
2024-03-08,PROD007,Jilin,9,50,41
2024-03-09,PROD019,Shenzhen,9,380,371
2024-03-10,PROD004,Shenzhen,6,180,174
2024-03-11,PROD003,Shenzhen,3,709,706
2024-03-12,PROD011,Beijing,3,1119,1116
2024-03-13,PROD020,Beijing,10,709,699
2024-03-14,PROD003,Shanghai,10,798,788
2024-03-15,PROD005,Beijing,10,360,350
2024-03-16,PROD006,Shenzhen,9,54,45
2024-03-17,PROD008,Jilin,1,334,333
2024-03-18,PROD011,Beijing,8,1116,1108
2024-03-19,PROD017,Shenzhen,10,525,515
2024-03-20,PROD016,Shanghai,3,836,833
2024-03-21,PROD011,Shenzhen,1,630,629
2024-03-22,PROD005,Guangzhou,4,188,184
2024-03-23,PROD001,Guangzhou,1,876,875
2024-03-24,PROD010,Jilin,3,91,88
2024-03-25,PROD008,Shenzhen,2,429,427
2024-03-26,PROD002,Beijing,4,676,672
2024-03-27,PROD002,Beijing,3,672,669
2024-03-28,PROD014,Guangzhou,6,49,43
2024-03-29,PROD019,Guangzhou,8,878,870
2024-03-30,PROD019,Beijing,3,303,300
2024-03-31,PROD012,Beijing,10,698,688
2024-04-01,PROD017,Shanghai,3,450,447
2024-04-02,PROD015,Beijing,7,460,453
2024-04-03,PROD015,Shenzhen,1,478,477
2024-04-04,PROD013,Beijing,2,889,887
2024-04-05,PROD013,Shenzhen,5,848,843
2024-04-06,PROD001,Shanghai,9,634,625
2024-04-07,PROD018,Guangzhou,8,715,707
2024-04-08,PROD002,Jilin,4,523,519
2024-04-09,PROD020,Shanghai,10,122,112
2024-04-10,PROD010,Guangzhou,10,924,914
2024-04-11,PROD020,Shenzhen,7,751,744
2024-04-12,PROD012,Shenzhen,9,0,0
2024-04-13,PROD004,Jilin,9,124,115
2024-04-14,PROD011,Jilin,7,82,75
2024-04-15,PROD008,Beijing,7,196,189
2024-04-16,PROD004,Beijing,8,364,356
2024-04-17,PROD014,Shanghai,10,333,323
2024-04-18,PROD013,Shenzhen,8,843,835
2024-04-19,PROD016,Guangzhou,8,113,105
2024-04-20,PROD012,Beijing,9,688,679
2024-04-21,PROD018,Shanghai,9,569,560
2024-04-22,PROD012,Shenzhen,8,0,0
2024-04-23,PROD017,Guangzhou,10,42,32
2024-04-24,PROD016,Shanghai,4,833,829
2024-04-25,PROD018,Shenzhen,10,830,820
2024-04-26,PROD013,Shenzhen,5,835,830
2024-04-27,PROD002,Shanghai,8,293,285
2024-04-28,PROD004,Jilin,9,115,106
2024-04-29,PROD012,Guangzhou,5,183,178
2024-04-30,PROD013,Jilin,9,494,485
2024-05-01,PROD003,Shenzhen,9,706,697
2024-05-02,PROD019,Shenzhen,10,371,361
2024-05-03,PROD016,Shenzhen,5,54,49
2024-05-04,PROD011,Shenzhen,6,629,623
2024-05-05,PROD003,Jilin,5,909,904
2024-05-06,PROD003,Shenzhen,1,697,696
2024-05-07,PROD014,Beijing,1,273,272
2024-05-08,PROD005,Shenzhen,1,318,317
2024-05-09,PROD014,Beijing,5,272,267
2024-05-10,PROD017,Shenzhen,10,515,505
2024-05-11,PROD001,Beijing,10,31,21
2024-05-12,PROD018,Beijing,4,563,559
2024-05-13,PROD002,Jilin,3,519,516
2024-05-14,PROD006,Jilin,2,488,486
2024-05-15,PROD006,Guangzhou,4,908,904
2024-05-16,PROD020,Guangzhou,7,192,185
2024-05-17,PROD009,Shenzhen,2,374,372
2024-05-18,PROD010,Guangzhou,4,914,910
2024-05-19,PROD014,Jilin,10,325,315
2024-05-20,PROD009,Beijing,10,228,218
2024-05-21,PROD010,Shanghai,10,304,294
2024-05-22,PROD012,Jilin,10,593,583
2024-05-23,PROD007,Beijing,4,0,0
2024-05-24,PROD015,Guangzhou,2,397,395
2024-05-25,PROD019,Guangzhou,3,870,867
2024-05-26,PROD016,Beijing,2,836,834
2024-05-27,PROD001,Beijing,6,21,15
2024-05-28,PROD005,Jilin,6,459,453
2024-05-29,PROD005,Shanghai,9,585,576
2024-05-30,PROD002,Jilin,6,516,510
2024-05-31,PROD020,Jilin,2,816,814
2024-06-01,PROD012,Shenzhen,7,0,0
2024-06-02,PROD017,Shenzhen,8,505,497
2024-06-03,PROD009,Beijing,1,218,217
2024-06-04,PROD020,Shanghai,4,112,108
2024-06-05,PROD018,Guangzhou,8,707,699
2024-06-06,PROD015,Shanghai,7,121,114
2024-06-07,PROD004,Beijing,9,356,347
2024-06-08,PROD010,Jilin,4,88,84
2024-06-09,PROD001,Jilin,9,283,274
2024-06-10,PROD014,Beijing,3,267,264
2024-06-11,PROD019,Shanghai,2,699,697
2024-06-12,PROD020,Jilin,1,814,813
2024-06-13,PROD012,Guangzhou,2,178,176
2024-06-14,PROD006,Beijing,10,634,624
2024-06-15,PROD015,Jilin,1,738,737
2024-06-16,PROD015,Guangzhou,10,395,385
2024-06-17,PROD009,Shanghai,6,259,253
2024-06-18,PROD016,Guangzhou,8,105,97
2024-06-19,PROD016,Beijing,3,834,831
2024-06-20,PROD002,Jilin,6,510,504
2024-06-21,PROD019,Shanghai,2,697,695
2024-06-22,PROD005,Shenzhen,4,317,313
2024-06-23,PROD001,Beijing,6,15,9
2024-06-24,PROD019,Shanghai,3,695,692
2024-06-25,PROD006,Guangzhou,7,904,897
2024-06-26,PROD006,Beijing,2,624,622
2024-06-27,PROD012,Guangzhou,10,176,166
2024-06-28,PROD015,Shenzhen,3,477,474
2024-06-29,PROD016,Jilin,2,477,475
2024-06-30,PROD011,Guangzhou,8,455,447
2024-07-01,PROD006,Shenzhen,9,45,36
2024-07-02,PROD017,Shenzhen,7,497,490
2024-07-03,PROD009,Beijing,4,217,213
2024-07-04,PROD010,Shanghai,4,294,290
2024-07-05,PROD004,Shanghai,8,925,917
2024-07-06,PROD007,Shanghai,5,322,317
2024-07-07,PROD013,Beijing,7,887,880
2024-07-08,PROD007,Shanghai,2,317,315
2024-07-09,PROD010,Beijing,10,932,922
2024-07-10,PROD002,Jilin,7,504,497
2024-07-11,PROD019,Shanghai,4,692,688
2024-07-12,PROD019,Shenzhen,10,361,351
2024-07-13,PROD008,Beijing,6,189,183
2024-07-14,PROD009,Beijing,1,213,212
2024-07-15,PROD016,Shanghai,1,829,828
2024-07-16,PROD012,Guangzhou,8,166,158
2024-07-17,PROD009,Guangzhou,9,932,923
2024-07-18,PROD008,Shenzhen,10,427,417
2024-07-19,PROD009,Beijing,6,212,206
2024-07-20,PROD011,Shenzhen,1,623,622
2024-07-21,PROD019,Beijing,2,300,298
2024-07-22,PROD010,Shenzhen,4,592,588
2024-07-23,PROD014,Shenzhen,7,381,374
2024-07-24,PROD010,Jilin,8,84,76
2024-07-25,PROD014,Shenzhen,8,374,366
2024-07-26,PROD002,Jilin,2,497,495
2024-07-27,PROD001,Shenzhen,3,306,303
2024-07-28,PROD003,Jilin,2,904,902
2024-07-29,PROD010,Shanghai,7,290,283
2024-07-30,PROD009,Beijing,5,206,201
2024-07-31,PROD006,Shenzhen,8,36,28
2024-08-01,PROD003,Guangzhou,1,650,649
2024-08-02,PROD003,Guangzhou,10,649,639
2024-08-03,PROD009,Jilin,2,125,123
2024-08-04,PROD017,Shanghai,8,447,439
2024-08-05,PROD017,Jilin,10,822,812
2024-08-06,PROD018,Jilin,1,1030,1029
2024-08-07,PROD017,Beijing,4,913,909
2024-08-08,PROD004,Shanghai,5,917,912
2024-08-09,PROD018,Jilin,3,1029,1026
2024-08-10,PROD007,Beijing,9,0,0
2024-08-11,PROD016,Jilin,2,475,473
2024-08-12,PROD011,Shanghai,4,297,293
2024-08-13,PROD010,Guangzhou,7,910,903
2024-08-14,PROD001,Shenzhen,4,303,299
2024-08-15,PROD017,Shanghai,9,439,430
2024-08-16,PROD015,Shanghai,10,114,104
2024-08-17,PROD016,Guangzhou,1,97,96
2024-08-18,PROD009,Shenzhen,4,372,368
2024-08-19,PROD002,Guangzhou,9,674,665
2024-08-20,PROD003,Shenzhen,5,696,691
2024-08-21,PROD020,Beijing,1,699,698
2024-08-22,PROD014,Jilin,10,315,305
2024-08-23,PROD018,Beijing,7,559,552
2024-08-24,PROD006,Guangzhou,10,897,887
2024-08-25,PROD011,Shanghai,2,293,291
2024-08-26,PROD003,Shenzhen,2,691,689
2024-08-27,PROD014,Shenzhen,7,366,359
2024-08-28,PROD015,Shenzhen,10,474,464
2024-08-29,PROD019,Shanghai,1,688,687
2024-08-30,PROD011,Shanghai,8,291,283
2024-08-31,PROD009,Beijing,7,201,194
2024-09-01,PROD015,Jilin,2,737,735
2024-09-02,PROD003,Jilin,5,902,897
2024-09-03,PROD008,Jilin,7,333,326
2024-09-04,PROD013,Shanghai,10,645,635
2024-09-05,PROD017,Guangzhou,7,32,25
2024-09-06,PROD008,Shenzhen,10,417,407
2024-09-07,PROD002,Beijing,7,669,662
2024-09-08,PROD006,Beijing,6,622,616
2024-09-09,PROD014,Beijing,5,264,259
2024-09-10,PROD011,Beijing,2,1108,1106
2024-09-11,PROD003,Guangzhou,5,639,634
2024-09-12,PROD017,Shanghai,9,430,421
2024-09-13,PROD015,Jilin,4,735,731
2024-09-14,PROD008,Shenzhen,6,407,401
2024-09-15,PROD005,Guangzhou,3,184,181
2024-09-16,PROD014,Beijing,4,259,255
2024-09-17,PROD020,Jilin,6,813,807
2024-09-18,PROD015,Beijing,6,453,447
2024-09-19,PROD002,Jilin,7,495,488
2024-09-20,PROD020,Shenzhen,7,744,737
2024-09-21,PROD007,Guangzhou,10,689,679
2024-09-22,PROD011,Guangzhou,4,447,443
2024-09-23,PROD015,Shenzhen,5,464,459
2024-09-24,PROD019,Beijing,6,298,292
2024-09-25,PROD014,Guangzhou,1,43,42
2024-09-26,PROD011,Beijing,7,1106,1099
2024-09-27,PROD016,Shanghai,8,828,820
2024-09-28,PROD008,Jilin,2,326,324
2024-09-29,PROD014,Beijing,7,255,248
2024-09-30,PROD015,Shanghai,7,104,97
2024-10-01,PROD011,Jilin,9,75,66
2024-10-02,PROD015,Jilin,5,731,726
2024-10-03,PROD020,Shenzhen,2,737,735
2024-10-04,PROD016,Shanghai,8,820,812
2024-10-05,PROD008,Guangzhou,10,920,910
2024-10-06,PROD003,Guangzhou,2,634,632
2024-10-07,PROD018,Shenzhen,5,820,815
2024-10-08,PROD001,Shanghai,9,625,616
2024-10-09,PROD013,Beijing,5,880,875
2024-10-10,PROD001,Shanghai,3,616,613
2024-10-11,PROD005,Shenzhen,9,313,304
2024-10-12,PROD013,Shenzhen,8,830,822
2024-10-13,PROD017,Guangzhou,10,25,15
2024-10-14,PROD017,Shanghai,6,421,415
2024-10-15,PROD012,Jilin,10,583,573
2024-10-16,PROD011,Jilin,4,66,62
2024-10-17,PROD018,Beijing,5,552,547
2024-10-18,PROD018,Shenzhen,8,815,807
2024-10-19,PROD007,Guangzhou,3,679,676
2024-10-20,PROD010,Shanghai,7,283,276
2024-10-21,PROD005,Beijing,2,350,348
2024-10-22,PROD019,Shanghai,1,687,686
2024-10-23,PROD016,Beijing,8,831,823
2024-10-24,PROD017,Beijing,1,909,908
2024-10-25,PROD010,Shenzhen,3,588,585
2024-10-26,PROD005,Shenzhen,10,304,294
2024-10-27,PROD003,Jilin,8,897,889
2024-10-28,PROD017,Guangzhou,1,15,14
2024-10-29,PROD001,Jilin,1,274,273
2024-10-30,PROD012,Jilin,10,573,563
2024-10-31,PROD007,Beijing,3,0,0
2024-11-01,PROD003,Shenzhen,1,689,688
2024-11-02,PROD006,Shenzhen,1,28,27
2024-11-03,PROD013,Guangzhou,1,409,408
2024-11-04,PROD020,Beijing,6,698,692
2024-11-05,PROD006,Shenzhen,9,27,18
2024-11-06,PROD012,Shanghai,8,616,608
2024-11-07,PROD005,Jilin,3,453,450
2024-11-08,PROD007,Shenzhen,10,298,288
2024-11-09,PROD004,Guangzhou,6,901,895
2024-11-10,PROD014,Shanghai,3,323,320
2024-11-11,PROD011,Guangzhou,4,443,439
2024-11-12,PROD017,Beijing,3,908,905
2024-11-13,PROD017,Beijing,8,905,897
2024-11-14,PROD014,Jilin,2,305,303
2024-11-15,PROD007,Shanghai,3,315,312
2024-11-16,PROD001,Beijing,8,9,1
2024-11-17,PROD019,Shenzhen,10,351,341
2024-11-18,PROD002,Jilin,9,488,479
2024-11-19,PROD009,Jilin,6,123,117
2024-11-20,PROD005,Beijing,7,348,341
2024-11-21,PROD007,Jilin,7,41,34
2024-11-22,PROD005,Shanghai,9,576,567
2024-11-23,PROD005,Shenzhen,5,294,289
2024-11-24,PROD008,Shanghai,2,162,160
2024-11-25,PROD004,Jilin,1,106,105
2024-11-26,PROD020,Guangzhou,4,185,181
2024-11-27,PROD008,Shanghai,3,160,157
2024-11-28,PROD003,Beijing,9,941,932
2024-11-29,PROD010,Shanghai,10,276,266
2024-11-30,PROD004,Shanghai,3,912,909
2024-12-01,PROD001,Jilin,6,273,267
2024-12-02,PROD008,Shanghai,2,157,155
2024-12-03,PROD007,Shanghai,3,312,309
2024-12-04,PROD009,Shenzhen,5,368,363
2024-12-05,PROD003,Shenzhen,8,688,680
2024-12-06,PROD009,Shanghai,9,253,244
2024-12-07,PROD016,Beijing,9,823,814
2024-12-08,PROD009,Beijing,5,194,189
2024-12-09,PROD018,Jilin,1,1026,1025
2024-12-10,PROD020,Shenzhen,7,735,728
2024-12-11,PROD002,Beijing,2,662,660
2024-12-12,PROD003,Jilin,1,889,888
2024-12-13,PROD006,Guangzhou,7,887,880
2024-12-14,PROD015,Beijing,7,447,440
2024-12-15,PROD014,Shanghai,9,320,311
2024-12-16,PROD004,Jilin,3,105,102
2024-12-17,PROD002,Guangzhou,2,665,663
2024-12-18,PROD002,Jilin,3,479,476
2024-12-19,PROD005,Beijing,3,341,338
2024-12-20,PROD014,Shenzhen,4,359,355
2024-12-21,PROD018,Jilin,9,1025,1016
2024-12-22,PROD012,Jilin,3,563,560
2024-12-23,PROD008,Guangzhou,1,910,909
2024-12-24,PROD018,Jilin,8,1016,1008
2024-12-25,PROD010,Guangzhou,9,903,894
2024-12-26,PROD005,Beijing,1,338,337
2024-12-27,PROD004,Guangzhou,1,895,894
2024-12-28,PROD011,Beijing,9,1099,1090
2024-12-29,PROD020,Beijing,4,692,688
2024-12-30,PROD009,Jilin,4,117,113
2024-01-01,PROD003,Beijing,2,932,930
2024-01-02,PROD017,Guangzhou,4,14,10
2024-01-03,PROD002,Shanghai,5,285,280
2024-01-04,PROD010,Beijing,3,922,919
2024-01-05,PROD002,Jilin,5,476,471
2024-01-06,PROD008,Beijing,8,183,175
2024-01-07,PROD014,Jilin,3,303,300
2024-01-08,PROD013,Jilin,4,485,481
2024-01-09,PROD013,Shanghai,3,635,632
2024-01-10,PROD014,Jilin,1,300,299
2024-01-11,PROD008,Shenzhen,10,401,391
2024-01-12,PROD008,Jilin,3,324,321
2024-01-13,PROD004,Shanghai,4,909,905
2024-01-14,PROD004,Shanghai,4,905,901
2024-01-15,PROD016,Jilin,5,473,468
2024-01-16,PROD019,Beijing,4,292,288
2024-01-17,PROD001,Jilin,7,267,260
2024-01-18,PROD004,Guangzhou,9,894,885
2024-01-19,PROD004,Beijing,1,347,346
2024-01-20,PROD020,Shanghai,8,108,100
2024-01-21,PROD016,Jilin,9,468,459
2024-01-22,PROD017,Shenzhen,7,490,483
2024-01-23,PROD007,Shanghai,1,309,308
2024-01-24,PROD005,Shenzhen,8,289,281
2024-01-25,PROD020,Guangzhou,9,181,172
2024-01-26,PROD002,Beijing,4,660,656
2024-01-27,PROD011,Guangzhou,9,439,430
2024-01-28,PROD018,Beijing,1,547,546
2024-01-29,PROD001,Shenzhen,7,299,292
2024-01-30,PROD020,Shanghai,6,100,94
2024-01-31,PROD006,Beijing,4,616,612
2024-02-01,PROD006,Jilin,1,486,485
2024-02-02,PROD020,Guangzhou,10,172,162
2024-02-03,PROD018,Beijing,6,546,540
2024-02-04,PROD004,Shenzhen,7,174,167
2024-02-05,PROD016,Shanghai,3,812,809
2024-02-06,PROD004,Jilin,7,102,95
2024-02-07,PROD016,Shanghai,6,809,803
2024-02-08,PROD004,Shenzhen,8,167,159
2024-02-09,PROD010,Beijing,2,919,917
2024-02-10,PROD009,Shanghai,10,244,234
2024-02-11,PROD012,Guangzhou,5,158,153
2024-02-12,PROD020,Guangzhou,5,162,157
2024-02-13,PROD018,Guangzhou,5,699,694
2024-02-14,PROD010,Beijing,10,917,907
2024-02-15,PROD018,Shenzhen,10,807,797
2024-02-16,PROD001,Guangzhou,10,875,865
2024-02-17,PROD007,Beijing,5,0,0
2024-02-18,PROD017,Beijing,3,897,894
2024-02-19,PROD004,Beijing,2,346,344
2024-02-20,PROD017,Guangzhou,8,10,2
2024-02-21,PROD003,Shenzhen,4,680,676
2024-02-22,PROD015,Shanghai,9,97,88
2024-02-23,PROD006,Beijing,1,612,611
2024-02-24,PROD014,Jilin,4,299,295
2024-02-25,PROD011,Shenzhen,5,622,617
2024-02-26,PROD007,Shanghai,8,308,300
2024-02-27,PROD009,Jilin,5,113,108
2024-02-28,PROD014,Beijing,7,248,241
2024-02-29,PROD013,Beijing,7,875,868
2024-03-01,PROD005,Guangzhou,2,181,179
2024-03-02,PROD012,Shenzhen,1,0,0
2024-03-03,PROD011,Shenzhen,10,617,607
2024-03-04,PROD017,Shenzhen,7,483,476
2024-03-05,PROD020,Jilin,10,807,797
2024-03-06,PROD009,Jilin,2,108,106
2024-03-07,PROD005,Jilin,6,450,444
2024-03-08,PROD020,Jilin,7,797,790
2024-03-09,PROD019,Guangzhou,1,867,866
2024-03-10,PROD020,Beijing,7,688,681
2024-03-11,PROD014,Shanghai,1,311,310
2024-03-12,PROD017,Shenzhen,2,476,474
2024-03-13,PROD015,Shanghai,8,88,80
2024-03-14,PROD013,Beijing,2,868,866
2024-03-15,PROD014,Shanghai,1,310,309
2024-03-16,PROD008,Shenzhen,4,391,387
2024-03-17,PROD008,Shenzhen,1,387,386
2024-03-18,PROD015,Shanghai,10,80,70
2024-03-19,PROD018,Jilin,10,1008,998
2024-03-20,PROD003,Shenzhen,3,676,673
2024-03-21,PROD010,Jilin,8,76,68
2024-03-22,PROD010,Shenzhen,8,585,577
2024-03-23,PROD016,Guangzhou,1,96,95
2024-03-24,PROD006,Beijing,2,611,609
2024-03-25,PROD014,Shenzhen,6,355,349
2024-03-26,PROD015,Beijing,6,440,434
2024-03-27,PROD018,Shenzhen,2,797,795
2024-03-28,PROD015,Shanghai,8,70,62
2024-03-29,PROD011,Beijing,4,1090,1086
2024-03-30,PROD014,Beijing,6,241,235
2024-03-31,PROD020,Shanghai,3,94,91
2024-04-01,PROD011,Beijing,4,1086,1082
2024-04-02,PROD004,Shanghai,4,901,897
2024-04-03,PROD018,Guangzhou,2,694,692
2024-04-04,PROD001,Jilin,5,260,255
2024-04-05,PROD002,Shanghai,3,280,277
2024-04-06,PROD003,Shanghai,3,788,785
2024-04-07,PROD020,Shenzhen,8,728,720
2024-04-08,PROD020,Beijing,4,681,677
2024-04-09,PROD010,Jilin,6,68,62
2024-04-10,PROD001,Jilin,6,255,249
2024-04-11,PROD006,Shanghai,5,76,71
2024-04-12,PROD019,Guangzhou,10,866,856
2024-04-13,PROD005,Jilin,9,444,435
2024-04-14,PROD006,Jilin,9,485,476
2024-04-15,PROD005,Beijing,7,337,330
2024-04-16,PROD019,Jilin,1,539,538
2024-04-17,PROD003,Shanghai,4,785,781
2024-04-18,PROD011,Beijing,8,1082,1074
2024-04-19,PROD006,Shenzhen,4,18,14
2024-04-20,PROD020,Shenzhen,3,720,717
2024-04-21,PROD006,Beijing,3,609,606
2024-04-22,PROD003,Jilin,2,888,886
2024-04-23,PROD013,Beijing,10,866,856
2024-04-24,PROD016,Jilin,7,459,452
2024-04-25,PROD007,Beijing,4,0,0
2024-04-26,PROD019,Jilin,1,538,537
2024-04-27,PROD010,Guangzhou,3,894,891
2024-04-28,PROD001,Shanghai,5,613,608
2024-04-29,PROD018,Jilin,1,998,997
2024-04-30,PROD014,Beijing,8,235,227
2024-05-01,PROD012,Guangzhou,2,153,151
2024-05-02,PROD016,Jilin,9,452,443
2024-05-03,PROD003,Beijing,3,930,927
2024-05-04,PROD012,Shenzhen,8,0,0
2024-05-05,PROD015,Jilin,1,726,725
2024-05-06,PROD002,Shanghai,9,277,268
2024-05-07,PROD012,Shenzhen,10,0,0
2024-05-08,PROD010,Shenzhen,4,577,573
2024-05-09,PROD005,Beijing,10,330,320
2024-05-10,PROD002,Beijing,8,656,648
2024-05-11,PROD008,Shenzhen,10,386,376
2024-05-12,PROD018,Jilin,6,997,991
2024-05-13,PROD020,Beijing,2,677,675
2024-05-14,PROD017,Jilin,7,812,805
2024-05-15,PROD013,Guangzhou,1,408,407
2024-05-16,PROD007,Shanghai,8,300,292
2024-05-17,PROD018,Shenzhen,2,795,793
2024-05-18,PROD015,Shanghai,10,62,52
2024-05-19,PROD012,Beijing,10,679,669
2024-05-20,PROD002,Beijing,10,648,638
2024-05-21,PROD015,Shanghai,5,52,47
2024-05-22,PROD013,Shanghai,4,632,628
2024-05-23,PROD018,Beijing,8,540,532
2024-05-24,PROD015,Beijing,5,434,429
2024-05-25,PROD004,Shanghai,3,897,894
2024-05-26,PROD016,Shanghai,8,803,795
2024-05-27,PROD011,Shanghai,9,283,274
2024-05-28,PROD013,Jilin,5,481,476
2024-05-29,PROD002,Shenzhen,7,760,753
2024-05-30,PROD010,Shanghai,10,266,256
2024-05-31,PROD001,Guangzhou,2,865,863
2024-06-01,PROD018,Guangzhou,4,692,688
2024-06-02,PROD001,Beijing,6,1,0
2024-06-03,PROD017,Shenzhen,5,474,469
2024-06-04,PROD008,Beijing,9,175,166
2024-06-05,PROD012,Beijing,4,669,665
2024-06-06,PROD014,Guangzhou,9,42,33
2024-06-07,PROD015,Guangzhou,4,385,381
2024-06-08,PROD003,Shenzhen,6,673,667
2024-06-09,PROD018,Shanghai,3,560,557
2024-06-10,PROD005,Beijing,9,320,311
2024-06-11,PROD015,Shanghai,6,47,41
2024-06-12,PROD018,Jilin,9,991,982
2024-06-13,PROD003,Shanghai,10,781,771
2024-06-14,PROD019,Shanghai,4,686,682
2024-06-15,PROD007,Beijing,8,0,0
2024-06-16,PROD018,Guangzhou,1,688,687
2024-06-17,PROD001,Guangzhou,3,863,860
2024-06-18,PROD018,Guangzhou,1,687,686
2024-06-19,PROD010,Jilin,8,62,54
2024-06-20,PROD019,Jilin,2,537,535
2024-06-21,PROD005,Shanghai,2,567,565
2024-06-22,PROD002,Guangzhou,10,663,653
2024-06-23,PROD018,Shanghai,1,557,556
2024-06-24,PROD004,Shanghai,7,894,887
2024-06-25,PROD010,Shanghai,6,256,250
2024-06-26,PROD013,Guangzhou,5,407,402
2024-06-27,PROD017,Guangzhou,1,2,1
2024-06-28,PROD011,Shenzhen,6,607,601
2024-06-29,PROD016,Guangzhou,1,95,94
2024-06-30,PROD003,Shenzhen,2,667,665
2024-07-01,PROD012,Beijing,1,665,664
2024-07-02,PROD002,Shanghai,4,268,264
2024-07-03,PROD016,Jilin,10,443,433
2024-07-04,PROD001,Shenzhen,4,292,288
2024-07-05,PROD016,Beijing,5,814,809
2024-07-06,PROD004,Guangzhou,10,885,875
2024-07-07,PROD003,Shanghai,3,771,768
2024-07-08,PROD005,Jilin,7,435,428
2024-07-09,PROD019,Beijing,7,288,281
2024-07-10,PROD012,Shanghai,10,608,598
2024-07-11,PROD013,Guangzhou,2,402,400
2024-07-12,PROD004,Beijing,2,344,342
2024-07-13,PROD010,Beijing,8,907,899
2024-07-14,PROD007,Jilin,6,34,28
2024-07-15,PROD020,Shenzhen,6,717,711
2024-07-16,PROD001,Shanghai,8,608,600
2024-07-17,PROD004,Shanghai,8,887,879
2024-07-18,PROD001,Guangzhou,5,860,855
2024-07-19,PROD001,Beijing,6,0,0
2024-07-20,PROD007,Shenzhen,4,288,284
2024-07-21,PROD014,Beijing,6,227,221
2024-07-22,PROD002,Beijing,4,638,634
2024-07-23,PROD018,Beijing,9,532,523
2024-07-24,PROD008,Beijing,9,166,157
2024-07-25,PROD010,Shenzhen,9,573,564
2024-07-26,PROD004,Shanghai,5,879,874
2024-07-27,PROD019,Shenzhen,1,341,340
2024-07-28,PROD019,Beijing,3,281,278
2024-07-29,PROD020,Beijing,8,675,667
2024-07-30,PROD012,Shenzhen,6,0,0
2024-07-31,PROD005,Jilin,2,428,426
2024-08-01,PROD001,Shenzhen,5,288,283
2024-08-02,PROD019,Shenzhen,3,340,337
2024-08-03,PROD013,Beijing,3,856,853
2024-08-04,PROD020,Shenzhen,9,711,702
2024-08-05,PROD016,Beijing,4,809,805
2024-08-06,PROD014,Shanghai,6,309,303
2024-08-07,PROD001,Shanghai,9,600,591
2024-08-08,PROD020,Beijing,4,667,663
2024-08-09,PROD019,Beijing,5,278,273
2024-08-10,PROD003,Jilin,7,886,879
2024-08-11,PROD018,Guangzhou,5,686,681
2024-08-12,PROD013,Beijing,2,853,851
2024-08-13,PROD011,Shanghai,3,274,271
2024-08-14,PROD020,Jilin,7,790,783
2024-08-15,PROD014,Guangzhou,9,33,24
2024-08-16,PROD009,Jilin,3,106,103
2024-08-17,PROD010,Shanghai,10,250,240
2024-08-18,PROD015,Shanghai,9,41,32
2024-08-19,PROD010,Shenzhen,7,564,557
2024-08-20,PROD016,Shanghai,6,795,789
2024-08-21,PROD014,Shenzhen,9,349,340
2024-08-22,PROD019,Jilin,1,535,534
2024-08-23,PROD014,Beijing,4,221,217
2024-08-24,PROD015,Shenzhen,1,459,458
2024-08-25,PROD016,Jilin,6,433,427
2024-08-26,PROD018,Jilin,9,982,973
2024-08-27,PROD010,Shenzhen,7,557,550
2024-08-28,PROD002,Shanghai,3,264,261
2024-08-29,PROD015,Guangzhou,4,381,377
2024-08-30,PROD009,Guangzhou,1,923,922
2024-08-31,PROD018,Jilin,10,973,963
2024-09-01,PROD006,Guangzhou,7,880,873
2024-09-02,PROD014,Beijing,6,217,211
2024-09-03,PROD010,Guangzhou,1,891,890
2024-09-04,PROD008,Shanghai,2,155,153
2024-09-05,PROD020,Shanghai,8,91,83
2024-09-06,PROD011,Guangzhou,3,430,427
2024-09-07,PROD011,Beijing,8,1074,1066
2024-09-08,PROD017,Beijing,8,894,886
2024-09-09,PROD018,Guangzhou,6,681,675
2024-09-10,PROD005,Shenzhen,6,281,275
2024-09-11,PROD006,Shanghai,3,71,68
2024-09-12,PROD010,Beijing,8,899,891
2024-09-13,PROD020,Jilin,10,783,773
2024-09-14,PROD013,Guangzhou,10,400,390
2024-09-15,PROD013,Beijing,9,851,842
2024-09-16,PROD011,Beijing,7,1066,1059
2024-09-17,PROD018,Shanghai,4,556,552
2024-09-18,PROD007,Guangzhou,7,676,669
2024-09-19,PROD009,Shenzhen,8,363,355
2024-09-20,PROD017,Shanghai,6,415,409
2024-09-21,PROD016,Shanghai,8,789,781
2024-09-22,PROD016,Shenzhen,6,49,43
2024-09-23,PROD007,Beijing,6,0,0
2024-09-24,PROD019,Shenzhen,6,337,331
2024-09-25,PROD008,Jilin,2,321,319
2024-09-26,PROD003,Shanghai,4,768,764
2024-09-27,PROD007,Beijing,9,0,0
2024-09-28,PROD013,Jilin,7,476,469
2024-09-29,PROD002,Shenzhen,5,753,748
2024-09-30,PROD010,Guangzhou,8,890,882
2024-10-01,PROD010,Beijing,1,891,890
2024-10-02,PROD015,Beijing,4,429,425
2024-10-03,PROD001,Shanghai,3,591,588
2024-10-04,PROD002,Shenzhen,10,748,738
2024-10-05,PROD017,Jilin,5,805,800
2024-10-06,PROD016,Beijing,3,805,802
2024-10-07,PROD004,Shenzhen,8,159,151
2024-10-08,PROD020,Shenzhen,2,702,700
2024-10-09,PROD004,Guangzhou,7,875,868
2024-10-10,PROD010,Guangzhou,5,882,877
2024-10-11,PROD015,Jilin,9,725,716
2024-10-12,PROD016,Jilin,1,427,426
2024-10-13,PROD001,Jilin,2,249,247
2024-10-14,PROD018,Beijing,4,523,519
2024-10-15,PROD008,Jilin,2,319,317
2024-10-16,PROD006,Guangzhou,1,873,872
2024-10-17,PROD003,Shenzhen,1,665,664
2024-10-18,PROD016,Beijing,7,802,795
2024-10-19,PROD005,Shenzhen,8,275,267
2024-10-20,PROD015,Beijing,3,425,422
2024-10-21,PROD003,Jilin,6,879,873
2024-10-22,PROD008,Beijing,8,157,149
2024-10-23,PROD001,Beijing,8,0,0
2024-10-24,PROD009,Shanghai,8,234,226
2024-10-25,PROD006,Jilin,10,476,466
2024-10-26,PROD002,Jilin,5,471,466
2024-10-27,PROD007,Jilin,9,28,19
2024-10-28,PROD008,Guangzhou,10,909,899
2024-10-29,PROD017,Beijing,4,886,882
2024-10-30,PROD006,Shenzhen,8,14,6
2024-10-31,PROD010,Guangzhou,6,877,871
2024-11-01,PROD014,Shenzhen,2,340,338
2024-11-02,PROD017,Shanghai,3,409,406
2024-11-03,PROD004,Shanghai,4,874,870
2024-11-04,PROD017,Shenzhen,2,469,467
2024-11-05,PROD014,Beijing,9,211,202
2024-11-06,PROD010,Shenzhen,9,550,541
2024-11-07,PROD009,Jilin,2,103,101
2024-11-08,PROD008,Jilin,9,317,308
2024-11-09,PROD010,Shanghai,5,240,235
2024-11-10,PROD006,Shenzhen,3,6,3
2024-11-11,PROD013,Guangzhou,9,390,381
2024-11-12,PROD018,Beijing,5,519,514
2024-11-13,PROD005,Shanghai,2,565,563
2024-11-14,PROD012,Beijing,2,664,662
2024-11-15,PROD005,Beijing,9,311,302
2024-11-16,PROD020,Beijing,10,663,653
2024-11-17,PROD010,Beijing,4,890,886
2024-11-18,PROD008,Shenzhen,3,376,373
2024-11-19,PROD004,Beijing,2,342,340
2024-11-20,PROD018,Guangzhou,7,675,668
2024-11-21,PROD002,Shanghai,3,261,258
2024-11-22,PROD006,Beijing,5,606,601
2024-11-23,PROD006,Guangzhou,3,872,869
2024-11-24,PROD008,Beijing,4,149,145
2024-11-25,PROD005,Beijing,8,302,294
2024-11-26,PROD017,Jilin,4,800,796
2024-11-27,PROD007,Shanghai,7,292,285
2024-11-28,PROD015,Shanghai,4,32,28
2024-11-29,PROD016,Guangzhou,5,94,89
2024-11-30,PROD001,Guangzhou,4,855,851
2024-12-01,PROD020,Shenzhen,1,700,699
2024-12-02,PROD018,Guangzhou,5,668,663
2024-12-03,PROD018,Guangzhou,5,663,658
2024-12-04,PROD008,Jilin,4,308,304
2024-12-05,PROD007,Shanghai,1,285,284
2024-12-06,PROD019,Beijing,7,273,266
2024-12-07,PROD009,Beijing,1,189,188
2024-12-08,PROD017,Guangzhou,10,1,0
2024-12-09,PROD018,Jilin,2,963,961
2024-12-10,PROD007,Jilin,10,19,9
2024-12-11,PROD004,Beijing,6,340,334
2024-12-12,PROD014,Shanghai,4,303,299
2024-12-13,PROD007,Guangzhou,5,669,664
2024-12-14,PROD016,Beijing,9,795,786
2024-12-15,PROD006,Guangzhou,6,869,863
2024-12-16,PROD020,Shenzhen,5,699,694
2024-12-17,PROD015,Guangzhou,5,377,372
2024-12-18,PROD002,Guangzhou,1,653,652
2024-12-19,PROD001,Guangzhou,6,851,845
2024-12-20,PROD017,Shanghai,6,406,400
2024-12-21,PROD004,Jilin,10,95,85
2024-12-22,PROD004,Shenzhen,10,151,141
2024-12-23,PROD020,Shanghai,3,83,80
2024-12-24,PROD005,Guangzhou,2,179,177
2024-12-25,PROD005,Guangzhou,5,177,172
2024-12-26,PROD016,Shanghai,8,781,773
2024-12-27,PROD008,Shanghai,9,153,144
2024-12-28,PROD007,Beijing,4,0,0
2024-12-29,PROD010,Beijing,10,886,876
2024-12-30,PROD015,Shenzhen,6,458,452
2024-01-01,PROD013,Beijing,8,842,834
2024-01-02,PROD002,Shenzhen,7,738,731
2024-01-03,PROD020,Beijing,7,653,646
2024-01-04,PROD019,Shenzhen,5,331,326
2024-01-05,PROD002,Shenzhen,1,731,730
2024-01-06,PROD005,Guangzhou,4,172,168
2024-01-07,PROD020,Shanghai,8,80,72
2024-01-08,PROD015,Beijing,9,422,413
2024-01-09,PROD010,Beijing,4,876,872
2024-01-10,PROD009,Shenzhen,7,355,348
2024-01-11,PROD019,Beijing,1,266,265
2024-01-12,PROD003,Shenzhen,6,664,658
2024-01-13,PROD011,Beijing,4,1059,1055
2024-01-14,PROD012,Jilin,7,560,553
2024-01-15,PROD015,Beijing,5,413,408
2024-01-16,PROD002,Jilin,1,466,465
2024-01-17,PROD014,Shenzhen,8,338,330
2024-01-18,PROD007,Guangzhou,2,664,662
2024-01-19,PROD015,Shenzhen,8,452,444
2024-01-20,PROD007,Jilin,2,9,7
2024-01-21,PROD017,Jilin,4,796,792
2024-01-22,PROD002,Shenzhen,2,730,728
2024-01-23,PROD007,Beijing,10,0,0
2024-01-24,PROD011,Shanghai,3,271,268
2024-01-25,PROD018,Beijing,3,514,511
2024-01-26,PROD020,Beijing,7,646,639
2024-01-27,PROD015,Guangzhou,8,372,364
2024-01-28,PROD001,Shanghai,9,588,579
2024-01-29,PROD013,Shenzhen,5,822,817
2024-01-30,PROD003,Shanghai,4,764,760
2024-01-31,PROD012,Shanghai,5,598,593
2024-02-01,PROD002,Jilin,7,465,458
2024-02-02,PROD013,Jilin,1,469,468
2024-02-03,PROD018,Guangzhou,1,658,657
2024-02-04,PROD004,Shanghai,9,870,861
2024-02-05,PROD003,Shenzhen,3,658,655
2024-02-06,PROD005,Shanghai,1,563,562
2024-02-07,PROD020,Jilin,5,773,768
2024-02-08,PROD004,Beijing,3,334,331
2024-02-09,PROD008,Guangzhou,7,899,892
2024-02-10,PROD019,Guangzhou,9,856,847
2024-02-11,PROD018,Guangzhou,6,657,651
2024-02-12,PROD012,Shenzhen,8,0,0
2024-02-13,PROD005,Jilin,7,426,419
2024-02-14,PROD014,Shanghai,10,299,289
2024-02-15,PROD011,Jilin,3,62,59
2024-02-16,PROD015,Beijing,1,408,407
2024-02-17,PROD004,Guangzhou,10,868,858
2024-02-18,PROD008,Jilin,4,304,300
2024-02-19,PROD018,Jilin,10,961,951
2024-02-20,PROD011,Guangzhou,6,427,421
2024-02-21,PROD006,Guangzhou,2,863,861
2024-02-22,PROD004,Shenzhen,6,141,135
2024-02-23,PROD004,Shanghai,9,861,852
2024-02-24,PROD009,Shenzhen,10,348,338
2024-02-25,PROD019,Guangzhou,10,847,837
2024-02-26,PROD003,Jilin,8,873,865
2024-02-27,PROD004,Beijing,3,331,328
2024-02-28,PROD012,Guangzhou,9,151,142
2024-02-29,PROD001,Jilin,8,247,239
2024-03-01,PROD007,Shenzhen,2,284,282
2024-03-02,PROD012,Shenzhen,1,0,0
2024-03-03,PROD018,Jilin,10,951,941
2024-03-04,PROD017,Jilin,2,792,790
2024-03-05,PROD003,Beijing,3,927,924
2024-03-06,PROD018,Guangzhou,2,651,649
2024-03-07,PROD015,Guangzhou,7,364,357
2024-03-08,PROD009,Beijing,3,188,185
2024-03-09,PROD008,Shenzhen,2,373,371
2024-03-10,PROD002,Beijing,4,634,630
2024-03-11,PROD016,Shenzhen,6,43,37
2024-03-12,PROD004,Shenzhen,7,135,128
2024-03-13,PROD013,Beijing,9,834,825
2024-03-14,PROD002,Jilin,4,458,454
2024-03-15,PROD012,Shenzhen,1,0,0
2024-03-16,PROD008,Shanghai,4,144,140
2024-03-17,PROD007,Shanghai,4,284,280
2024-03-18,PROD016,Guangzhou,4,89,85
2024-03-19,PROD010,Beijing,2,872,870
2024-03-20,PROD012,Guangzhou,9,142,133
2024-03-21,PROD014,Jilin,6,295,289
2024-03-22,PROD019,Shenzhen,2,326,324
2024-03-23,PROD009,Guangzhou,5,922,917
2024-03-24,PROD007,Beijing,6,0,0
2024-03-25,PROD001,Shanghai,4,579,575
2024-03-26,PROD003,Jilin,6,865,859
2024-03-27,PROD002,Beijing,1,630,629
2024-03-28,PROD015,Beijing,9,407,398
2024-03-29,PROD014,Guangzhou,5,24,19
2024-03-30,PROD013,Shanghai,8,628,620
2024-03-31,PROD014,Shanghai,10,289,279
2024-04-01,PROD017,Shenzhen,5,467,462
2024-04-02,PROD005,Shanghai,6,562,556
2024-04-03,PROD018,Shanghai,10,552,542
2024-04-04,PROD002,Jilin,6,454,448
2024-04-05,PROD010,Guangzhou,9,871,862
2024-04-06,PROD002,Shanghai,5,258,253
2024-04-07,PROD001,Shenzhen,4,283,279
2024-04-08,PROD012,Beijing,8,662,654
2024-04-09,PROD011,Guangzhou,7,421,414
2024-04-10,PROD014,Jilin,6,289,283
2024-04-11,PROD014,Shenzhen,9,330,321
2024-04-12,PROD006,Shenzhen,6,3,0
2024-04-13,PROD012,Shenzhen,6,0,0
2024-04-14,PROD006,Guangzhou,6,861,855
2024-04-15,PROD006,Jilin,7,466,459
2024-04-16,PROD005,Shanghai,4,556,552
2024-04-17,PROD015,Shenzhen,3,444,441
2024-04-18,PROD014,Jilin,2,283,281
2024-04-19,PROD002,Beijing,6,629,623
2024-04-20,PROD014,Beijing,9,202,193
2024-04-21,PROD012,Guangzhou,8,133,125
2024-04-22,PROD001,Guangzhou,2,845,843
2024-04-23,PROD014,Beijing,10,193,183
2024-04-24,PROD010,Shanghai,10,235,225
2024-04-25,PROD015,Guangzhou,4,357,353
2024-04-26,PROD017,Guangzhou,10,0,0
2024-04-27,PROD019,Shenzhen,6,324,318
2024-04-28,PROD017,Guangzhou,10,0,0
2024-04-29,PROD006,Guangzhou,5,855,850
2024-04-30,PROD002,Beijing,7,623,616
2024-05-01,PROD004,Guangzhou,10,858,848
2024-05-02,PROD015,Jilin,10,716,706
2024-05-03,PROD009,Beijing,1,185,184
2024-05-04,PROD011,Beijing,10,1055,1045
2024-05-05,PROD012,Guangzhou,6,125,119
2024-05-06,PROD003,Shanghai,10,760,750
2024-05-07,PROD012,Shenzhen,10,0,0
2024-05-08,PROD011,Shenzhen,7,601,594
2024-05-09,PROD011,Jilin,3,59,56
2024-05-10,PROD014,Beijing,10,183,173
2024-05-11,PROD006,Jilin,8,459,451
2024-05-12,PROD003,Shanghai,6,750,744
2024-05-13,PROD020,Shenzhen,1,694,693
2024-05-14,PROD007,Jilin,3,7,4
2024-05-15,PROD001,Jilin,2,239,237
2024-05-16,PROD020,Guangzhou,10,157,147
2024-05-17,PROD008,Beijing,8,145,137
2024-05-18,PROD009,Beijing,1,184,183
2024-05-19,PROD019,Beijing,5,265,260
2024-05-20,PROD001,Shanghai,5,575,570
2024-05-21,PROD006,Shenzhen,9,0,0
2024-05-22,PROD004,Beijing,1,328,327
2024-05-23,PROD012,Shanghai,6,593,587
2024-05-24,PROD020,Beijing,2,639,637
